CTCGTGTAACA -> TCGTGTAACAC
TCGTGTAACAC -> CGTGTAACACG
CGTGTAACACG -> GTGTAACACGG
GTGTAACACGG -> TGTAACACGGC
TGTAACACGGC -> GTAACACGGCT
GTAACACGGCT -> TAACACGGCTG
TAACACGGCTG -> AACACGGCTGG
AACACGGCTGG -> ACACGGCTGGA
ACACGGCTGGA -> CACGGCTGGAC
CACGGCTGGAC -> ACGGCTGGACC
ACGGCTGGACC -> CGGCTGGACCC
CGGCTGGACCC -> GGCTGGACCCT
GGCTGGACCCT -> GCTGGACCCTT
GCTGGACCCTT -> CTGGACCCTTA
CTGGACCCTTA -> TGGACCCTTAT
TGGACCCTTAT -> GGACCCTTATC
GGACCCTTATC -> GACCCTTATCA
GACCCTTATCA -> ACCCTTATCAA
ACCCTTATCAA -> CCCTTATCAAC
CCCTTATCAAC -> CCTTATCAACG
CCTTATCAACG -> CTTATCAACGT
CTTATCAACGT -> TTATCAACGTA
TTATCAACGTA -> TATCAACGTAC
TATCAACGTAC -> ATCAACGTACT
ATCAACGTACT -> TCAACGTACTC
TCAACGTACTC -> CAACGTACTCG
CAACGTACTCG -> AACGTACTCGA
AACGTACTCGA -> ACGTACTCGAT
ACGTACTCGAT -> CGTACTCGATG
CGTACTCGATG -> GTACTCGATGA
GTACTCGATGA -> TACTCGATGAT
TACTCGATGAT -> ACTCGATGATG
ACTCGATGATG -> CTCGATGATGT
CTCGATGATGT -> TCGATGATGTT
TCGATGATGTT -> CGATGATGTTA
CGATGATGTTA -> GATGATGTTAG
GATGATGTTAG -> ATGATGTTAGA
ATGATGTTAGA -> TGATGTTAGAG
TGATGTTAGAG -> GATGTTAGAGC
GATGTTAGAGC -> ATGTTAGAGCG
ATGTTAGAGCG -> TGTTAGAGCGT
TGTTAGAGCGT -> GTTAGAGCGTA
GTTAGAGCGTA -> TTAGAGCGTAG
TTAGAGCGTAG -> TAGAGCGTAGA
TAGAGCGTAGA -> AGAGCGTAGAG
AGAGCGTAGAG -> GAGCGTAGAGG
GAGCGTAGAGG -> AGCGTAGAGGT
AGCGTAGAGGT -> GCGTAGAGGTT
GCGTAGAGGTT -> CGTAGAGGTTA
CGTAGAGGTTA -> GTAGAGGTTAC
GTAGAGGTTAC -> TAGAGGTTACC
TAGAGGTTACC -> AGAGGTTACCC
AGAGGTTACCC -> GAGGTTACCCC
GAGGTTACCCC -> AGGTTACCCCT
AGGTTACCCCT -> GGTTACCCCTA
GGTTACCCCTA -> GTTACCCCTAA
GTTACCCCTAA -> TTACCCCTAAT
TTACCCCTAAT -> TACCCCTAATT
TACCCCTAATT -> ACCCCTAATTC
ACCCCTAATTC -> CCCCTAATTCC
CCCCTAATTCC -> CCCTAATTCCA
CCCTAATTCCA -> CCTAATTCCAG
CCTAATTCCAG -> CTAATTCCAGA
CTAATTCCAGA -> TAATTCCAGAT
TAATTCCAGAT -> AATTCCAGATT
AATTCCAGATT -> ATTCCAGATTG
ATTCCAGATTG -> TTCCAGATTGC
TTCCAGATTGC -> TCCAGATTGCC
TCCAGATTGCC -> CCAGATTGCCG
CCAGATTGCCG -> CAGATTGCCGA
CAGATTGCCGA -> AGATTGCCGAG
AGATTGCCGAG -> GATTGCCGAGA
GATTGCCGAGA -> ATTGCCGAGAC
ATTGCCGAGAC -> TTGCCGAGACC
TTGCCGAGACC -> TGCCGAGACCC
TGCCGAGACCC -> GCCGAGACCCC
GCCGAGACCCC -> CCGAGACCCCG
CCGAGACCCCG -> CGAGACCCCGT
CGAGACCCCGT -> GAGACCCCGTT
GAGACCCCGTT -> AGACCCCGTTA
AGACCCCGTTA -> GACCCCGTTAC
GACCCCGTTAC -> ACCCCGTTACG
ACCCCGTTACG -> CCCCGTTACGA
CCCCGTTACGA -> CCCGTTACGAT
CCCGTTACGAT -> CCGTTACGATC
CCGTTACGATC -> CGTTACGATCA
CGTTACGATCA -> GTTACGATCAG
GTTACGATCAG -> TTACGATCAGT
TTACGATCAGT -> TACGATCAGTA
TACGATCAGTA -> ACGATCAGTAC
ACGATCAGTAC -> CGATCAGTACA
CGATCAGTACA -> GATCAGTACAT
GATCAGTACAT -> ATCAGTACATG
ATCAGTACATG -> TCAGTACATGT
TCAGTACATGT -> CAGTACATGTT
CAGTACATGTT -> AGTACATGTTT
AGTACATGTTT -> GTACATGTTTA
GTACATGTTTA -> TACATGTTTAC
TACATGTTTAC -> ACATGTTTACG
ACATGTTTACG -> CATGTTTACGG
CATGTTTACGG -> ATGTTTACGGT
ATGTTTACGGT -> TGTTTACGGTA
TGTTTACGGTA -> GTTTACGGTAC
GTTTACGGTAC -> TTTACGGTACC
TTTACGGTACC -> TTACGGTACCG
TTACGGTACCG -> TACGGTACCGA
TACGGTACCGA -> ACGGTACCGAT
ACGGTACCGAT -> CGGTACCGATG
CGGTACCGATG -> GGTACCGATGA
GGTACCGATGA -> GTACCGATGAC
GTACCGATGAC -> TACCGATGACT
TACCGATGACT -> ACCGATGACTC
ACCGATGACTC -> CCGATGACTCG
CCGATGACTCG -> CGATGACTCGC
CGATGACTCGC -> GATGACTCGCG
GATGACTCGCG -> ATGACTCGCGC
ATGACTCGCGC -> TGACTCGCGCG
TGACTCGCGCG -> GACTCGCGCGA
GACTCGCGCGA -> ACTCGCGCGAT
ACTCGCGCGAT -> CTCGCGCGATG
CTCGCGCGATG -> TCGCGCGATGC
TCGCGCGATGC -> CGCGCGATGCA
CGCGCGATGCA -> GCGCGATGCAA
GCGCGATGCAA -> CGCGATGCAAG
CGCGATGCAAG -> GCGATGCAAGC
GCGATGCAAGC -> CGATGCAAGCG
CGATGCAAGCG -> GATGCAAGCGA
GATGCAAGCGA -> ATGCAAGCGAA
ATGCAAGCGAA -> TGCAAGCGAAT
TGCAAGCGAAT -> GCAAGCGAATC
GCAAGCGAATC -> CAAGCGAATCT
CAAGCGAATCT -> AAGCGAATCTG
AAGCGAATCTG -> AGCGAATCTGT
AGCGAATCTGT -> GCGAATCTGTT
GCGAATCTGTT -> CGAATCTGTTG
CGAATCTGTTG -> GAATCTGTTGC
GAATCTGTTGC -> AATCTGTTGCT
AATCTGTTGCT -> ATCTGTTGCTG
ATCTGTTGCTG -> TCTGTTGCTGC
TCTGTTGCTGC -> CTGTTGCTGCG
CTGTTGCTGCG -> TGTTGCTGCGT
TGTTGCTGCGT -> GTTGCTGCGTA
GTTGCTGCGTA -> TTGCTGCGTAG
TTGCTGCGTAG -> TGCTGCGTAGG
TGCTGCGTAGG -> GCTGCGTAGGC
GCTGCGTAGGC -> CTGCGTAGGCA
CTGCGTAGGCA -> TGCGTAGGCAT
TGCGTAGGCAT -> GCGTAGGCATT
GCGTAGGCATT -> CGTAGGCATTC
CGTAGGCATTC -> GTAGGCATTCC
GTAGGCATTCC -> TAGGCATTCCT
TAGGCATTCCT -> AGGCATTCCTT
AGGCATTCCTT -> GGCATTCCTTC
GGCATTCCTTC -> GCATTCCTTCT
GCATTCCTTCT -> CATTCCTTCTT
CATTCCTTCTT -> ATTCCTTCTTG
ATTCCTTCTTG -> TTCCTTCTTGC
TTCCTTCTTGC -> TCCTTCTTGCG
TCCTTCTTGCG -> CCTTCTTGCGT
CCTTCTTGCGT -> CTTCTTGCGTA
CTTCTTGCGTA -> TTCTTGCGTAA
TTCTTGCGTAA -> TCTTGCGTAAT
TCTTGCGTAAT -> CTTGCGTAATG
CTTGCGTAATG -> TTGCGTAATGG
TTGCGTAATGG -> TGCGTAATGGC
TGCGTAATGGC -> GCGTAATGGCT
GCGTAATGGCT -> CGTAATGGCTT
CGTAATGGCTT -> GTAATGGCTTA
GTAATGGCTTA -> TAATGGCTTAC
TAATGGCTTAC -> AATGGCTTACT
AATGGCTTACT -> ATGGCTTACTC
ATGGCTTACTC -> TGGCTTACTCT
TGGCTTACTCT -> GGCTTACTCTG
GGCTTACTCTG -> GCTTACTCTGC
GCTTACTCTGC -> CTTACTCTGCC
CTTACTCTGCC -> TTACTCTGCCA
TTACTCTGCCA -> TACTCTGCCAG
TACTCTGCCAG -> ACTCTGCCAGT
ACTCTGCCAGT -> CTCTGCCAGTA
CTCTGCCAGTA -> TCTGCCAGTAC
TCTGCCAGTAC -> CTGCCAGTACA
CTGCCAGTACA -> TGCCAGTACAG
TGCCAGTACAG -> GCCAGTACAGA
GCCAGTACAGA -> CCAGTACAGAA
CCAGTACAGAA -> CAGTACAGAAC
CAGTACAGAAC -> AGTACAGAACG
AGTACAGAACG -> GTACAGAACGA
GTACAGAACGA -> TACAGAACGAT
TACAGAACGAT -> ACAGAACGATT
ACAGAACGATT -> CAGAACGATTC
CAGAACGATTC -> AGAACGATTCT
AGAACGATTCT -> GAACGATTCTG
GAACGATTCTG -> AACGATTCTGA
AACGATTCTGA -> ACGATTCTGAT
ACGATTCTGAT -> CGATTCTGATT
CGATTCTGATT -> GATTCTGATTC
GATTCTGATTC -> ATTCTGATTCA
ATTCTGATTCA -> TTCTGATTCAG
TTCTGATTCAG -> TCTGATTCAGT
TCTGATTCAGT -> CTGATTCAGTT
CTGATTCAGTT -> TGATTCAGTTA
TGATTCAGTTA -> GATTCAGTTAG
GATTCAGTTAG -> ATTCAGTTAGC
ATTCAGTTAGC -> TTCAGTTAGCG
TTCAGTTAGCG -> TCAGTTAGCGA
TCAGTTAGCGA -> CAGTTAGCGAT
CAGTTAGCGAT -> AGTTAGCGATT
AGTTAGCGATT -> GTTAGCGATTC
GTTAGCGATTC -> TTAGCGATTCT
TTAGCGATTCT -> TAGCGATTCTA
TAGCGATTCTA -> AGCGATTCTAA
AGCGATTCTAA -> GCGATTCTAAC
GCGATTCTAAC -> CGATTCTAACT
CGATTCTAACT -> GATTCTAACTC
GATTCTAACTC -> ATTCTAACTCC
ATTCTAACTCC -> TTCTAACTCCT
TTCTAACTCCT -> TCTAACTCCTA
TCTAACTCCTA -> CTAACTCCTAC
CTAACTCCTAC -> TAACTCCTACC
TAACTCCTACC -> AACTCCTACCT
AACTCCTACCT -> ACTCCTACCTT
ACTCCTACCTT -> CTCCTACCTTT
CTCCTACCTTT -> TCCTACCTTTT
TCCTACCTTTT -> CCTACCTTTTG
CCTACCTTTTG -> CTACCTTTTGG
CTACCTTTTGG -> TACCTTTTGGG
TACCTTTTGGG -> ACCTTTTGGGT
ACCTTTTGGGT -> CCTTTTGGGTG
CCTTTTGGGTG -> CTTTTGGGTGA
CTTTTGGGTGA -> TTTTGGGTGAG
TTTTGGGTGAG -> TTTGGGTGAGC
TTTGGGTGAGC -> TTGGGTGAGCG
TTGGGTGAGCG -> TGGGTGAGCGC
TGGGTGAGCGC -> GGGTGAGCGCG
GGGTGAGCGCG -> GGTGAGCGCGC
GGTGAGCGCGC -> GTGAGCGCGCC
GTGAGCGCGCC -> TGAGCGCGCCA
TGAGCGCGCCA -> GAGCGCGCCAG
GAGCGCGCCAG -> AGCGCGCCAGA
AGCGCGCCAGA -> GCGCGCCAGAC
GCGCGCCAGAC -> CGCGCCAGACC
CGCGCCAGACC -> GCGCCAGACCT
GCGCCAGACCT -> CGCCAGACCTT
CGCCAGACCTT -> GCCAGACCTTT
GCCAGACCTTT -> CCAGACCTTTT
CCAGACCTTTT -> CAGACCTTTTC
CAGACCTTTTC -> AGACCTTTTCG
AGACCTTTTCG -> GACCTTTTCGG
GACCTTTTCGG -> ACCTTTTCGGC
ACCTTTTCGGC -> CCTTTTCGGCG
CCTTTTCGGCG -> CTTTTCGGCGT
CTTTTCGGCGT -> TTTTCGGCGTC
TTTTCGGCGTC -> TTTCGGCGTCA
TTTCGGCGTCA -> TTCGGCGTCAT
TTCGGCGTCAT -> TCGGCGTCATA
TCGGCGTCATA -> CGGCGTCATAA
CGGCGTCATAA -> GGCGTCATAAG
GGCGTCATAAG -> GCGTCATAAGG
GCGTCATAAGG -> CGTCATAAGGA
CGTCATAAGGA -> GTCATAAGGAG
GTCATAAGGAG -> TCATAAGGAGA
TCATAAGGAGA -> CATAAGGAGAT
CATAAGGAGAT -> ATAAGGAGATG
ATAAGGAGATG -> TAAGGAGATGC
TAAGGAGATGC -> AAGGAGATGCG
AAGGAGATGCG -> AGGAGATGCGC
AGGAGATGCGC -> GGAGATGCGCG
GGAGATGCGCG -> GAGATGCGCGG
GAGATGCGCGG -> AGATGCGCGGA
AGATGCGCGGA -> GATGCGCGGAA
GATGCGCGGAA -> ATGCGCGGAAG
ATGCGCGGAAG -> TGCGCGGAAGA
TGCGCGGAAGA -> GCGCGGAAGAT
GCGCGGAAGAT -> CGCGGAAGATC
CGCGGAAGATC -> GCGGAAGATCA
GCGGAAGATCA -> CGGAAGATCAT
CGGAAGATCAT -> GGAAGATCATC
GGAAGATCATC -> GAAGATCATCA
GAAGATCATCA -> AAGATCATCAC
AAGATCATCAC -> AGATCATCACG
AGATCATCACG -> GATCATCACGA
GATCATCACGA -> ATCATCACGAG
ATCATCACGAG -> TCATCACGAGT
TCATCACGAGT -> CATCACGAGTA
CATCACGAGTA -> ATCACGAGTAT
ATCACGAGTAT -> TCACGAGTATC
TCACGAGTATC -> CACGAGTATCC
CACGAGTATCC -> ACGAGTATCCT
ACGAGTATCCT -> CGAGTATCCTG
CGAGTATCCTG -> GAGTATCCTGT
GAGTATCCTGT -> AGTATCCTGTA
AGTATCCTGTA -> GTATCCTGTAC
GTATCCTGTAC -> TATCCTGTACA
TATCCTGTACA -> ATCCTGTACAT
ATCCTGTACAT -> TCCTGTACATT
TCCTGTACATT -> CCTGTACATTG
CCTGTACATTG -> CTGTACATTGT
CTGTACATTGT -> TGTACATTGTC
TGTACATTGTC -> GTACATTGTCA
GTACATTGTCA -> TACATTGTCAC
TACATTGTCAC -> ACATTGTCACG
ACATTGTCACG -> CATTGTCACGA
CATTGTCACGA -> ATTGTCACGAG
ATTGTCACGAG -> TTGTCACGAGA
TTGTCACGAGA -> TGTCACGAGAA
TGTCACGAGAA -> GTCACGAGAAC
GTCACGAGAAC -> TCACGAGAACT
TCACGAGAACT -> CACGAGAACTG
CACGAGAACTG -> ACGAGAACTGT
ACGAGAACTGT -> CGAGAACTGTT
CGAGAACTGTT -> GAGAACTGTTA
GAGAACTGTTA -> AGAACTGTTAG
AGAACTGTTAG -> GAACTGTTAGG
GAACTGTTAGG -> AACTGTTAGGG
AACTGTTAGGG -> ACTGTTAGGGC
ACTGTTAGGGC -> CTGTTAGGGCT
CTGTTAGGGCT -> TGTTAGGGCTA
TGTTAGGGCTA -> GTTAGGGCTAG
GTTAGGGCTAG -> TTAGGGCTAGA
TTAGGGCTAGA -> TAGGGCTAGAG
TAGGGCTAGAG -> AGGGCTAGAGC
AGGGCTAGAGC -> GGGCTAGAGCA
GGGCTAGAGCA -> GGCTAGAGCAG
GGCTAGAGCAG -> GCTAGAGCAGC
GCTAGAGCAGC -> CTAGAGCAGCT
CTAGAGCAGCT -> TAGAGCAGCTG
TAGAGCAGCTG -> AGAGCAGCTGC
AGAGCAGCTGC -> GAGCAGCTGCG
GAGCAGCTGCG -> AGCAGCTGCGT
AGCAGCTGCGT -> GCAGCTGCGTG
GCAGCTGCGTG -> CAGCTGCGTGA
CAGCTGCGTGA -> AGCTGCGTGAG
AGCTGCGTGAG -> GCTGCGTGAGG
GCTGCGTGAGG -> CTGCGTGAGGT
CTGCGTGAGGT -> TGCGTGAGGTA
TGCGTGAGGTA -> GCGTGAGGTAC
GCGTGAGGTAC -> CGTGAGGTACG
CGTGAGGTACG -> GTGAGGTACGA
GTGAGGTACGA -> TGAGGTACGAA
TGAGGTACGAA -> GAGGTACGAAA
GAGGTACGAAA -> AGGTACGAAAG
AGGTACGAAAG -> GGTACGAAAGT
GGTACGAAAGT -> GTACGAAAGTT
GTACGAAAGTT -> TACGAAAGTTC
TACGAAAGTTC -> ACGAAAGTTCT
ACGAAAGTTCT -> CGAAAGTTCTG
CGAAAGTTCTG -> GAAAGTTCTGT
GAAAGTTCTGT -> AAAGTTCTGTG
AAAGTTCTGTG -> AAGTTCTGTGC
AAGTTCTGTGC -> AGTTCTGTGCA
AGTTCTGTGCA -> GTTCTGTGCAT
GTTCTGTGCAT -> TTCTGTGCATC
TTCTGTGCATC -> TCTGTGCATCT
TCTGTGCATCT -> CTGTGCATCTG
CTGTGCATCTG -> TGTGCATCTGC
TGTGCATCTGC -> GTGCATCTGCA
GTGCATCTGCA -> TGCATCTGCAG
TGCATCTGCAG -> GCATCTGCAGA
GCATCTGCAGA -> CATCTGCAGAA
CATCTGCAGAA -> ATCTGCAGAAT
ATCTGCAGAAT -> TCTGCAGAATA
TCTGCAGAATA -> CTGCAGAATAA
CTGCAGAATAA -> TGCAGAATAAA
TGCAGAATAAA -> GCAGAATAAAA
GCAGAATAAAA -> CAGAATAAAAC
CAGAATAAAAC -> AGAATAAAACC
AGAATAAAACC -> GAATAAAACCC
GAATAAAACCC -> AATAAAACCCA
AATAAAACCCA -> ATAAAACCCAG
ATAAAACCCAG -> TAAAACCCAGG
TAAAACCCAGG -> AAAACCCAGGA
AAAACCCAGGA -> AAACCCAGGAC
AAACCCAGGAC -> AACCCAGGACC
AACCCAGGACC -> ACCCAGGACCG
ACCCAGGACCG -> CCCAGGACCGG
CCCAGGACCGG -> CCAGGACCGGT
CCAGGACCGGT -> CAGGACCGGTA
CAGGACCGGTA -> AGGACCGGTAA
AGGACCGGTAA -> GGACCGGTAAG
GGACCGGTAAG -> GACCGGTAAGG
GACCGGTAAGG -> ACCGGTAAGGT
ACCGGTAAGGT -> CCGGTAAGGTT
CCGGTAAGGTT -> CGGTAAGGTTT
CGGTAAGGTTT -> GGTAAGGTTTA
GGTAAGGTTTA -> GTAAGGTTTAG
GTAAGGTTTAG -> TAAGGTTTAGT
TAAGGTTTAGT -> AAGGTTTAGTA
AAGGTTTAGTA -> AGGTTTAGTAC
AGGTTTAGTAC -> GGTTTAGTACA
GGTTTAGTACA -> GTTTAGTACAA
GTTTAGTACAA -> TTTAGTACAAC
TTTAGTACAAC -> TTAGTACAACC
TTAGTACAACC -> TAGTACAACCC
TAGTACAACCC -> AGTACAACCCC
AGTACAACCCC -> GTACAACCCCA
GTACAACCCCA -> TACAACCCCAC
TACAACCCCAC -> ACAACCCCACT
ACAACCCCACT -> CAACCCCACTC
CAACCCCACTC -> AACCCCACTCT
AACCCCACTCT -> ACCCCACTCTA
ACCCCACTCTA -> CCCCACTCTAG
CCCCACTCTAG -> CCCACTCTAGA
CCCACTCTAGA -> CCACTCTAGAG
CCACTCTAGAG -> CACTCTAGAGA
CACTCTAGAGA -> ACTCTAGAGAC
ACTCTAGAGAC -> CTCTAGAGACT
CTCTAGAGACT -> TCTAGAGACTA
TCTAGAGACTA -> CTAGAGACTAA
CTAGAGACTAA -> TAGAGACTAAC
TAGAGACTAAC -> AGAGACTAACA
AGAGACTAACA -> GAGACTAACAG
GAGACTAACAG -> AGACTAACAGA
AGACTAACAGA -> GACTAACAGAC
GACTAACAGAC -> ACTAACAGACA
ACTAACAGACA -> CTAACAGACAG
CTAACAGACAG -> TAACAGACAGG
TAACAGACAGG -> AACAGACAGGT
AACAGACAGGT -> ACAGACAGGTG
ACAGACAGGTG -> CAGACAGGTGC
CAGACAGGTGC -> AGACAGGTGCT
AGACAGGTGCT -> GACAGGTGCTG
GACAGGTGCTG -> ACAGGTGCTGA
ACAGGTGCTGA -> CAGGTGCTGAG
CAGGTGCTGAG -> AGGTGCTGAGC
AGGTGCTGAGC -> GGTGCTGAGCA
GGTGCTGAGCA -> GTGCTGAGCAT
GTGCTGAGCAT -> TGCTGAGCATT
TGCTGAGCATT -> GCTGAGCATTT
GCTGAGCATTT -> CTGAGCATTTA
CTGAGCATTTA -> TGAGCATTTAG
TGAGCATTTAG -> GAGCATTTAGT
GAGCATTTAGT -> AGCATTTAGTT
AGCATTTAGTT -> GCATTTAGTTG
GCATTTAGTTG -> CATTTAGTTGT
CATTTAGTTGT -> ATTTAGTTGTT
ATTTAGTTGTT -> TTTAGTTGTTT
TTTAGTTGTTT -> TTAGTTGTTTG
TTAGTTGTTTG -> TAGTTGTTTGG
TAGTTGTTTGG -> AGTTGTTTGGA
AGTTGTTTGGA -> GTTGTTTGGAT
GTTGTTTGGAT -> TTGTTTGGATT
TTGTTTGGATT -> TGTTTGGATTT
TGTTTGGATTT -> GTTTGGATTTA
GTTTGGATTTA -> TTTGGATTTAC
TTTGGATTTAC -> TTGGATTTACT
TTGGATTTACT -> TGGATTTACTC
TGGATTTACTC -> GGATTTACTCG
GGATTTACTCG -> GATTTACTCGA
GATTTACTCGA -> ATTTACTCGAA
ATTTACTCGAA -> TTTACTCGAAG
TTTACTCGAAG -> TTACTCGAAGC
TTACTCGAAGC -> TACTCGAAGCA
TACTCGAAGCA -> ACTCGAAGCAC
ACTCGAAGCAC -> CTCGAAGCACT
CTCGAAGCACT -> TCGAAGCACTG
TCGAAGCACTG -> CGAAGCACTGC
CGAAGCACTGC -> GAAGCACTGCT
GAAGCACTGCT -> AAGCACTGCTC
AAGCACTGCTC -> AGCACTGCTCT
AGCACTGCTCT -> GCACTGCTCTC
GCACTGCTCTC -> CACTGCTCTCT
CACTGCTCTCT -> ACTGCTCTCTG
ACTGCTCTCTG -> CTGCTCTCTGA
CTGCTCTCTGA -> TGCTCTCTGAG
TGCTCTCTGAG -> GCTCTCTGAGG
GCTCTCTGAGG -> CTCTCTGAGGC
CTCTCTGAGGC -> TCTCTGAGGCG
TCTCTGAGGCG -> CTCTGAGGCGA
CTCTGAGGCGA -> TCTGAGGCGAC
TCTGAGGCGAC -> CTGAGGCGACT
CTGAGGCGACT -> TGAGGCGACTC
TGAGGCGACTC -> GAGGCGACTCC
GAGGCGACTCC -> AGGCGACTCCT
AGGCGACTCCT -> GGCGACTCCTG
GGCGACTCCTG -> GCGACTCCTGT
GCGACTCCTGT -> CGACTCCTGTC
CGACTCCTGTC -> GACTCCTGTCC
GACTCCTGTCC -> ACTCCTGTCCA
ACTCCTGTCCA -> CTCCTGTCCAA
CTCCTGTCCAA -> TCCTGTCCAAC
TCCTGTCCAAC -> CCTGTCCAACA
CCTGTCCAACA -> CTGTCCAACAA
CTGTCCAACAA -> TGTCCAACAAA
TGTCCAACAAA -> GTCCAACAAAC
GTCCAACAAAC -> TCCAACAAACC
TCCAACAAACC -> CCAACAAACCC
CCAACAAACCC -> CAACAAACCCC
CAACAAACCCC -> AACAAACCCCC
AACAAACCCCC -> ACAAACCCCCC
ACAAACCCCCC -> CAAACCCCCCT
CAAACCCCCCT -> AAACCCCCCTA
AAACCCCCCTA -> AACCCCCCTAT
AACCCCCCTAT -> ACCCCCCTATG
ACCCCCCTATG -> CCCCCCTATGA
CCCCCCTATGA -> CCCCCTATGAT
CCCCCTATGAT -> CCCCTATGATT
CCCCTATGATT -> CCCTATGATTT
CCCTATGATTT -> CCTATGATTTC
CCTATGATTTC -> CTATGATTTCG
CTATGATTTCG -> TATGATTTCGG
TATGATTTCGG -> ATGATTTCGGC
ATGATTTCGGC -> TGATTTCGGCA
TGATTTCGGCA -> GATTTCGGCAC
GATTTCGGCAC -> ATTTCGGCACC
ATTTCGGCACC -> TTTCGGCACCG
TTTCGGCACCG -> TTCGGCACCGA
TTCGGCACCGA -> TCGGCACCGAG
TCGGCACCGAG -> CGGCACCGAGC
CGGCACCGAGC -> GGCACCGAGCG
GGCACCGAGCG -> GCACCGAGCGC
GCACCGAGCGC -> CACCGAGCGCC
CACCGAGCGCC -> ACCGAGCGCCA
ACCGAGCGCCA -> CCGAGCGCCAA
CCGAGCGCCAA -> CGAGCGCCAAC
CGAGCGCCAAC -> GAGCGCCAACA
GAGCGCCAACA -> AGCGCCAACAC
AGCGCCAACAC -> GCGCCAACACG
GCGCCAACACG -> CGCCAACACGC
CGCCAACACGC -> GCCAACACGCA
GCCAACACGCA -> CCAACACGCAC
CCAACACGCAC -> CAACACGCACA
CAACACGCACA -> AACACGCACAC
AACACGCACAC -> ACACGCACACT
ACACGCACACT -> CACGCACACTC
CACGCACACTC -> ACGCACACTCG
ACGCACACTCG -> CGCACACTCGC
CGCACACTCGC -> GCACACTCGCG
GCACACTCGCG -> CACACTCGCGG
CACACTCGCGG -> ACACTCGCGGC
ACACTCGCGGC -> CACTCGCGGCA
CACTCGCGGCA -> ACTCGCGGCAA
ACTCGCGGCAA -> CTCGCGGCAAT
CTCGCGGCAAT -> TCGCGGCAATG
TCGCGGCAATG -> CGCGGCAATGG
CGCGGCAATGG -> GCGGCAATGGG
GCGGCAATGGG -> CGGCAATGGGG
CGGCAATGGGG -> GGCAATGGGGC
GGCAATGGGGC -> GCAATGGGGCC
GCAATGGGGCC -> CAATGGGGCCT
CAATGGGGCCT -> AATGGGGCCTA
AATGGGGCCTA -> ATGGGGCCTAA
ATGGGGCCTAA -> TGGGGCCTAAT
TGGGGCCTAAT -> GGGGCCTAATC
GGGGCCTAATC -> GGGCCTAATCT
GGGCCTAATCT -> GGCCTAATCTT
GGCCTAATCTT -> GCCTAATCTTA
GCCTAATCTTA -> CCTAATCTTAA
CCTAATCTTAA -> CTAATCTTAAA
CTAATCTTAAA -> TAATCTTAAAA
TAATCTTAAAA -> AATCTTAAAAG
AATCTTAAAAG -> ATCTTAAAAGA
ATCTTAAAAGA -> TCTTAAAAGAC
TCTTAAAAGAC -> CTTAAAAGACT
CTTAAAAGACT -> TTAAAAGACTG
TTAAAAGACTG -> TAAAAGACTGT
TAAAAGACTGT -> AAAAGACTGTT
AAAAGACTGTT -> AAAGACTGTTT
AAAGACTGTTT -> AAGACTGTTTG
AAGACTGTTTG -> AGACTGTTTGT
AGACTGTTTGT -> GACTGTTTGTC
GACTGTTTGTC -> ACTGTTTGTCT
ACTGTTTGTCT -> CTGTTTGTCTC
CTGTTTGTCTC -> TGTTTGTCTCG
TGTTTGTCTCG -> GTTTGTCTCGA
GTTTGTCTCGA -> TTTGTCTCGAC
TTTGTCTCGAC -> TTGTCTCGACC
TTGTCTCGACC -> TGTCTCGACCC
TGTCTCGACCC -> GTCTCGACCCG
GTCTCGACCCG -> TCTCGACCCGA
TCTCGACCCGA -> CTCGACCCGAA
CTCGACCCGAA -> TCGACCCGAAA
TCGACCCGAAA -> CGACCCGAAAA
CGACCCGAAAA -> GACCCGAAAAC
GACCCGAAAAC -> ACCCGAAAACT
ACCCGAAAACT -> CCCGAAAACTG
CCCGAAAACTG -> CCGAAAACTGC
CCGAAAACTGC -> CGAAAACTGCT
CGAAAACTGCT -> GAAAACTGCTT
GAAAACTGCTT -> AAAACTGCTTA
AAAACTGCTTA -> AAACTGCTTAA
AAACTGCTTAA -> AACTGCTTAAG
AACTGCTTAAG -> ACTGCTTAAGG
ACTGCTTAAGG -> CTGCTTAAGGC
CTGCTTAAGGC -> TGCTTAAGGCA
TGCTTAAGGCA -> GCTTAAGGCAA
GCTTAAGGCAA -> CTTAAGGCAAA
CTTAAGGCAAA -> TTAAGGCAAAG
TTAAGGCAAAG -> TAAGGCAAAGG
TAAGGCAAAGG -> AAGGCAAAGGT
AAGGCAAAGGT -> AGGCAAAGGTA
AGGCAAAGGTA -> GGCAAAGGTAA
GGCAAAGGTAA -> GCAAAGGTAAT
GCAAAGGTAAT -> CAAAGGTAATC
CAAAGGTAATC -> AAAGGTAATCA
AAAGGTAATCA -> AAGGTAATCAT
AAGGTAATCAT -> AGGTAATCATA
AGGTAATCATA -> GGTAATCATAA
GGTAATCATAA -> GTAATCATAAT
GTAATCATAAT -> TAATCATAATA
TAATCATAATA -> AATCATAATAG
AATCATAATAG -> ATCATAATAGA
ATCATAATAGA -> TCATAATAGAC
TCATAATAGAC -> CATAATAGACG
CATAATAGACG -> ATAATAGACGC
ATAATAGACGC -> TAATAGACGCG
TAATAGACGCG -> AATAGACGCGT
AATAGACGCGT -> ATAGACGCGTC
ATAGACGCGTC -> TAGACGCGTCT
TAGACGCGTCT -> AGACGCGTCTG
AGACGCGTCTG -> GACGCGTCTGG
GACGCGTCTGG -> ACGCGTCTGGC
ACGCGTCTGGC -> CGCGTCTGGCA
CGCGTCTGGCA -> GCGTCTGGCAT
GCGTCTGGCAT -> CGTCTGGCATG
CGTCTGGCATG -> GTCTGGCATGG
GTCTGGCATGG -> TCTGGCATGGG
TCTGGCATGGG -> CTGGCATGGGC
CTGGCATGGGC -> TGGCATGGGCC
TGGCATGGGCC -> GGCATGGGCCC
GGCATGGGCCC -> GCATGGGCCCG
GCATGGGCCCG -> CATGGGCCCGG
CATGGGCCCGG -> ATGGGCCCGGA
ATGGGCCCGGA -> TGGGCCCGGAG
TGGGCCCGGAG -> GGGCCCGGAGT
GGGCCCGGAGT -> GGCCCGGAGTG
GGCCCGGAGTG -> GCCCGGAGTGG
GCCCGGAGTGG -> CCCGGAGTGGC
CCCGGAGTGGC -> CCGGAGTGGCC
CCGGAGTGGCC -> CGGAGTGGCCA
CGGAGTGGCCA -> GGAGTGGCCAA
GGAGTGGCCAA -> GAGTGGCCAAC
GAGTGGCCAAC -> AGTGGCCAACG
AGTGGCCAACG -> GTGGCCAACGG
GTGGCCAACGG -> TGGCCAACGGC
TGGCCAACGGC -> GGCCAACGGCC
GGCCAACGGCC -> GCCAACGGCCC
GCCAACGGCCC -> CCAACGGCCCC
CCAACGGCCCC -> CAACGGCCCCA
CAACGGCCCCA -> AACGGCCCCAG
AACGGCCCCAG -> ACGGCCCCAGA
ACGGCCCCAGA -> CGGCCCCAGAT
CGGCCCCAGAT -> GGCCCCAGATA
GGCCCCAGATA -> GCCCCAGATAC
GCCCCAGATAC -> CCCCAGATACG
CCCCAGATACG -> CCCAGATACGC
CCCAGATACGC -> CCAGATACGCA
CCAGATACGCA -> CAGATACGCAT
CAGATACGCAT -> AGATACGCATT
AGATACGCATT -> GATACGCATTT
GATACGCATTT -> ATACGCATTTT
ATACGCATTTT -> TACGCATTTTT
TACGCATTTTT -> ACGCATTTTTG
ACGCATTTTTG -> CGCATTTTTGG
CGCATTTTTGG -> GCATTTTTGGT
GCATTTTTGGT -> CATTTTTGGTA
CATTTTTGGTA -> ATTTTTGGTAA
ATTTTTGGTAA -> TTTTTGGTAAT
TTTTTGGTAAT -> TTTTGGTAATA
TTTTGGTAATA -> TTTGGTAATAT
TTTGGTAATAT -> TTGGTAATATT
TTGGTAATATT -> TGGTAATATTG
TGGTAATATTG -> GGTAATATTGG
GGTAATATTGG -> GTAATATTGGC
GTAATATTGGC -> TAATATTGGCC
TAATATTGGCC -> AATATTGGCCG
AATATTGGCCG -> ATATTGGCCGG
ATATTGGCCGG -> TATTGGCCGGT
TATTGGCCGGT -> ATTGGCCGGTG
ATTGGCCGGTG -> TTGGCCGGTGC
TTGGCCGGTGC -> TGGCCGGTGCT
TGGCCGGTGCT -> GGCCGGTGCTC
GGCCGGTGCTC -> GCCGGTGCTCG
GCCGGTGCTCG -> CCGGTGCTCGA
CCGGTGCTCGA -> CGGTGCTCGAG
CGGTGCTCGAG -> GGTGCTCGAGG
GGTGCTCGAGG -> GTGCTCGAGGA
GTGCTCGAGGA -> TGCTCGAGGAT
TGCTCGAGGAT -> GCTCGAGGATA
GCTCGAGGATA -> CTCGAGGATAC
CTCGAGGATAC -> TCGAGGATACC
TCGAGGATACC -> CGAGGATACCA
CGAGGATACCA -> GAGGATACCAC
GAGGATACCAC -> AGGATACCACC
AGGATACCACC -> GGATACCACCC
GGATACCACCC -> GATACCACCCA
GATACCACCCA -> ATACCACCCAT
ATACCACCCAT -> TACCACCCATT
TACCACCCATT -> ACCACCCATTA
ACCACCCATTA -> CCACCCATTAG
CCACCCATTAG -> CACCCATTAGC
CACCCATTAGC -> ACCCATTAGCG
ACCCATTAGCG -> CCCATTAGCGC
CCCATTAGCGC -> CCATTAGCGCT
CCATTAGCGCT -> CATTAGCGCTT
CATTAGCGCTT -> ATTAGCGCTTT
ATTAGCGCTTT -> TTAGCGCTTTG
TTAGCGCTTTG -> TAGCGCTTTGG
TAGCGCTTTGG -> AGCGCTTTGGC
AGCGCTTTGGC -> GCGCTTTGGCT
GCGCTTTGGCT -> CGCTTTGGCTG
CGCTTTGGCTG -> GCTTTGGCTGA
GCTTTGGCTGA -> CTTTGGCTGAT
CTTTGGCTGAT -> TTTGGCTGATT
TTTGGCTGATT -> TTGGCTGATTC
TTGGCTGATTC -> TGGCTGATTCG
TGGCTGATTCG -> GGCTGATTCGT
GGCTGATTCGT -> GCTGATTCGTG
GCTGATTCGTG -> CTGATTCGTGG
CTGATTCGTGG -> TGATTCGTGGT
TGATTCGTGGT -> GATTCGTGGTA
GATTCGTGGTA -> ATTCGTGGTAG
ATTCGTGGTAG -> TTCGTGGTAGT
TTCGTGGTAGT -> TCGTGGTAGTT
TCGTGGTAGTT -> CGTGGTAGTTT
CGTGGTAGTTT -> GTGGTAGTTTT
GTGGTAGTTTT -> TGGTAGTTTTT
TGGTAGTTTTT -> GGTAGTTTTTA
GGTAGTTTTTA -> GTAGTTTTTAA
GTAGTTTTTAA -> TAGTTTTTAAC
TAGTTTTTAAC -> AGTTTTTAACC
AGTTTTTAACC -> GTTTTTAACCT
GTTTTTAACCT -> TTTTTAACCTG
TTTTTAACCTG -> TTTTAACCTGG
TTTTAACCTGG -> TTTAACCTGGA
TTTAACCTGGA -> TTAACCTGGAT
TTAACCTGGAT -> TAACCTGGATA
TAACCTGGATA -> AACCTGGATAC
AACCTGGATAC -> ACCTGGATACT
ACCTGGATACT -> CCTGGATACTG
CCTGGATACTG -> CTGGATACTGG
CTGGATACTGG -> TGGATACTGGG
TGGATACTGGG -> GGATACTGGGA
GGATACTGGGA -> GATACTGGGAG
GATACTGGGAG -> ATACTGGGAGT
ATACTGGGAGT -> TACTGGGAGTG
TACTGGGAGTG -> ACTGGGAGTGC
ACTGGGAGTGC -> CTGGGAGTGCC
CTGGGAGTGCC -> TGGGAGTGCCG
TGGGAGTGCCG -> GGGAGTGCCGA
GGGAGTGCCGA -> GGAGTGCCGAG
GGAGTGCCGAG -> GAGTGCCGAGT
GAGTGCCGAGT -> AGTGCCGAGTG
AGTGCCGAGTG -> GTGCCGAGTGG
GTGCCGAGTGG -> TGCCGAGTGGA
TGCCGAGTGGA -> GCCGAGTGGAG
GCCGAGTGGAG -> CCGAGTGGAGC
CCGAGTGGAGC -> CGAGTGGAGCT
CGAGTGGAGCT -> GAGTGGAGCTT
GAGTGGAGCTT -> AGTGGAGCTTT
AGTGGAGCTTT -> GTGGAGCTTTA
GTGGAGCTTTA -> TGGAGCTTTAT
TGGAGCTTTAT -> GGAGCTTTATA
GGAGCTTTATA -> GAGCTTTATAG
GAGCTTTATAG -> AGCTTTATAGG
AGCTTTATAGG -> GCTTTATAGGT
GCTTTATAGGT -> CTTTATAGGTC
CTTTATAGGTC -> TTTATAGGTCG
TTTATAGGTCG -> TTATAGGTCGG
TTATAGGTCGG -> TATAGGTCGGT
TATAGGTCGGT -> ATAGGTCGGTA
ATAGGTCGGTA -> TAGGTCGGTAC
TAGGTCGGTAC -> AGGTCGGTACT
AGGTCGGTACT -> GGTCGGTACTC
GGTCGGTACTC -> GTCGGTACTCT
GTCGGTACTCT -> TCGGTACTCTT
TCGGTACTCTT -> CGGTACTCTTT
CGGTACTCTTT -> GGTACTCTTTA
GGTACTCTTTA -> GTACTCTTTAT
GTACTCTTTAT -> TACTCTTTATT
TACTCTTTATT -> ACTCTTTATTG
ACTCTTTATTG -> CTCTTTATTGC
CTCTTTATTGC -> TCTTTATTGCC
TCTTTATTGCC -> CTTTATTGCCA
CTTTATTGCCA -> TTTATTGCCAT
TTTATTGCCAT -> TTATTGCCATT
TTATTGCCATT -> TATTGCCATTT
TATTGCCATTT -> ATTGCCATTTA
ATTGCCATTTA -> TTGCCATTTAG
TTGCCATTTAG -> TGCCATTTAGC
TGCCATTTAGC -> GCCATTTAGCA
GCCATTTAGCA -> CCATTTAGCAC
CCATTTAGCAC -> CATTTAGCACA
CATTTAGCACA -> ATTTAGCACAC
ATTTAGCACAC -> TTTAGCACACC
TTTAGCACACC -> TTAGCACACCG
TTAGCACACCG -> TAGCACACCGT
TAGCACACCGT -> AGCACACCGTG
AGCACACCGTG -> GCACACCGTGT
GCACACCGTGT -> CACACCGTGTG
CACACCGTGTG -> ACACCGTGTGC
ACACCGTGTGC -> CACCGTGTGCT
CACCGTGTGCT -> ACCGTGTGCTC
ACCGTGTGCTC -> CCGTGTGCTCG
CCGTGTGCTCG -> CGTGTGCTCGA
CGTGTGCTCGA -> GTGTGCTCGAC
GTGTGCTCGAC -> TGTGCTCGACA
TGTGCTCGACA -> GTGCTCGACAC
GTGCTCGACAC -> TGCTCGACACA
TGCTCGACACA -> GCTCGACACAA
GCTCGACACAA -> CTCGACACAAC
CTCGACACAAC -> TCGACACAACA
TCGACACAACA -> CGACACAACAT
CGACACAACAT -> GACACAACATT
GACACAACATT -> ACACAACATTG
ACACAACATTG -> CACAACATTGC
CACAACATTGC -> ACAACATTGCG
ACAACATTGCG -> CAACATTGCGC
CAACATTGCGC -> AACATTGCGCG
AACATTGCGCG -> ACATTGCGCGC
ACATTGCGCGC -> CATTGCGCGCG
CATTGCGCGCG -> ATTGCGCGCGG
ATTGCGCGCGG -> TTGCGCGCGGT
TTGCGCGCGGT -> TGCGCGCGGTA
TGCGCGCGGTA -> GCGCGCGGTAG
GCGCGCGGTAG -> CGCGCGGTAGC
CGCGCGGTAGC -> GCGCGGTAGCG
GCGCGGTAGCG -> CGCGGTAGCGA
CGCGGTAGCGA -> GCGGTAGCGAC
GCGGTAGCGAC -> CGGTAGCGACC
CGGTAGCGACC -> GGTAGCGACCT
GGTAGCGACCT -> GTAGCGACCTA
GTAGCGACCTA -> TAGCGACCTAT
TAGCGACCTAT -> AGCGACCTATA
AGCGACCTATA -> GCGACCTATAA
GCGACCTATAA -> CGACCTATAAA
CGACCTATAAA -> GACCTATAAAG
GACCTATAAAG -> ACCTATAAAGC
ACCTATAAAGC -> CCTATAAAGCG
CCTATAAAGCG -> CTATAAAGCGG
CTATAAAGCGG -> TATAAAGCGGA
TATAAAGCGGA -> ATAAAGCGGAG
ATAAAGCGGAG -> TAAAGCGGAGC
TAAAGCGGAGC -> AAAGCGGAGCA
AAAGCGGAGCA -> AAGCGGAGCAT
AAGCGGAGCAT -> AGCGGAGCATA
AGCGGAGCATA -> GCGGAGCATAG
GCGGAGCATAG -> CGGAGCATAGG
CGGAGCATAGG -> GGAGCATAGGT
GGAGCATAGGT -> GAGCATAGGTT
GAGCATAGGTT -> AGCATAGGTTG
AGCATAGGTTG -> GCATAGGTTGA
GCATAGGTTGA -> CATAGGTTGAT
CATAGGTTGAT -> ATAGGTTGATC
ATAGGTTGATC -> TAGGTTGATCG
TAGGTTGATCG -> AGGTTGATCGT
AGGTTGATCGT -> GGTTGATCGTG
GGTTGATCGTG -> GTTGATCGTGT
GTTGATCGTGT -> TTGATCGTGTA
TTGATCGTGTA -> TGATCGTGTAC
TGATCGTGTAC -> GATCGTGTACG
GATCGTGTACG -> ATCGTGTACGA
ATCGTGTACGA -> TCGTGTACGAC
TCGTGTACGAC -> CGTGTACGACG
CGTGTACGACG -> GTGTACGACGC
GTGTACGACGC -> TGTACGACGCC
TGTACGACGCC -> GTACGACGCCT
GTACGACGCCT -> TACGACGCCTA
TACGACGCCTA -> ACGACGCCTAA
ACGACGCCTAA -> CGACGCCTAAT
CGACGCCTAAT -> GACGCCTAATC
GACGCCTAATC -> ACGCCTAATCC
ACGCCTAATCC -> CGCCTAATCCA
CGCCTAATCCA -> GCCTAATCCAC
GCCTAATCCAC -> CCTAATCCACC
CCTAATCCACC -> CTAATCCACCG
CTAATCCACCG -> TAATCCACCGA
TAATCCACCGA -> AATCCACCGAA
AATCCACCGAA -> ATCCACCGAAT
ATCCACCGAAT -> TCCACCGAATG
TCCACCGAATG -> CCACCGAATGT
CCACCGAATGT -> CACCGAATGTT
CACCGAATGTT -> ACCGAATGTTT
ACCGAATGTTT -> CCGAATGTTTC
CCGAATGTTTC -> CGAATGTTTCG
CGAATGTTTCG -> GAATGTTTCGA
GAATGTTTCGA -> AATGTTTCGAT
AATGTTTCGAT -> ATGTTTCGATC
ATGTTTCGATC -> TGTTTCGATCG
TGTTTCGATCG -> GTTTCGATCGA
GTTTCGATCGA -> TTTCGATCGAC
TTTCGATCGAC -> TTCGATCGACT
TTCGATCGACT -> TCGATCGACTT
TCGATCGACTT -> CGATCGACTTA
CGATCGACTTA -> GATCGACTTAT
GATCGACTTAT -> ATCGACTTATA
ATCGACTTATA -> TCGACTTATAA
TCGACTTATAA -> CGACTTATAAG
CGACTTATAAG -> GACTTATAAGG
GACTTATAAGG -> ACTTATAAGGA
ACTTATAAGGA -> CTTATAAGGAA
CTTATAAGGAA -> TTATAAGGAAT
TTATAAGGAAT -> TATAAGGAATC
TATAAGGAATC -> ATAAGGAATCA
ATAAGGAATCA -> TAAGGAATCAA
TAAGGAATCAA -> AAGGAATCAAT
AAGGAATCAAT -> AGGAATCAATC
AGGAATCAATC -> GGAATCAATCT
GGAATCAATCT -> GAATCAATCTT
GAATCAATCTT -> AATCAATCTTC
AATCAATCTTC -> ATCAATCTTCA
ATCAATCTTCA -> TCAATCTTCAA
TCAATCTTCAA -> CAATCTTCAAT
CAATCTTCAAT -> AATCTTCAATC
AATCTTCAATC -> ATCTTCAATCA
ATCTTCAATCA -> TCTTCAATCAC
TCTTCAATCAC -> CTTCAATCACC
CTTCAATCACC -> TTCAATCACCT
TTCAATCACCT -> TCAATCACCTC
TCAATCACCTC -> CAATCACCTCT
CAATCACCTCT -> AATCACCTCTG
AATCACCTCTG -> ATCACCTCTGA
ATCACCTCTGA -> TCACCTCTGAA
TCACCTCTGAA -> CACCTCTGAAA
CACCTCTGAAA -> ACCTCTGAAAA
ACCTCTGAAAA -> CCTCTGAAAAG
CCTCTGAAAAG -> CTCTGAAAAGT
CTCTGAAAAGT -> TCTGAAAAGTC
TCTGAAAAGTC -> CTGAAAAGTCT
CTGAAAAGTCT -> TGAAAAGTCTC
TGAAAAGTCTC -> GAAAAGTCTCT
GAAAAGTCTCT -> AAAAGTCTCTA
AAAAGTCTCTA -> AAAGTCTCTAC
AAAGTCTCTAC -> AAGTCTCTACA
AAGTCTCTACA -> AGTCTCTACAC
AGTCTCTACAC -> GTCTCTACACT
GTCTCTACACT -> TCTCTACACTG
TCTCTACACTG -> CTCTACACTGA
CTCTACACTGA -> TCTACACTGAA
TCTACACTGAA -> CTACACTGAAG
CTACACTGAAG -> TACACTGAAGT
TACACTGAAGT -> ACACTGAAGTG
ACACTGAAGTG -> CACTGAAGTGA
CACTGAAGTGA -> ACTGAAGTGAG
ACTGAAGTGAG -> CTGAAGTGAGC
CTGAAGTGAGC -> TGAAGTGAGCC
TGAAGTGAGCC -> GAAGTGAGCCT
GAAGTGAGCCT -> AAGTGAGCCTA
AAGTGAGCCTA -> AGTGAGCCTAA
AGTGAGCCTAA -> GTGAGCCTAAT
GTGAGCCTAAT -> TGAGCCTAATT
TGAGCCTAATT -> GAGCCTAATTC
GAGCCTAATTC -> AGCCTAATTCA
AGCCTAATTCA -> GCCTAATTCAG
GCCTAATTCAG -> CCTAATTCAGT
CCTAATTCAGT -> CTAATTCAGTT
CTAATTCAGTT -> TAATTCAGTTT
TAATTCAGTTT -> AATTCAGTTTC
AATTCAGTTTC -> ATTCAGTTTCA
ATTCAGTTTCA -> TTCAGTTTCAA
TTCAGTTTCAA -> TCAGTTTCAAT
TCAGTTTCAAT -> CAGTTTCAATG
CAGTTTCAATG -> AGTTTCAATGC
AGTTTCAATGC -> GTTTCAATGCT
GTTTCAATGCT -> TTTCAATGCTC
TTTCAATGCTC -> TTCAATGCTCC
TTCAATGCTCC -> TCAATGCTCCA
TCAATGCTCCA -> CAATGCTCCAT
CAATGCTCCAT -> AATGCTCCATT
AATGCTCCATT -> ATGCTCCATTA
ATGCTCCATTA -> TGCTCCATTAA
TGCTCCATTAA -> GCTCCATTAAT
GCTCCATTAAT -> CTCCATTAATT
CTCCATTAATT -> TCCATTAATTC
TCCATTAATTC -> CCATTAATTCT
CCATTAATTCT -> CATTAATTCTT
CATTAATTCTT -> ATTAATTCTTC
ATTAATTCTTC -> TTAATTCTTCT
TTAATTCTTCT -> TAATTCTTCTC
TAATTCTTCTC -> AATTCTTCTCC
AATTCTTCTCC -> ATTCTTCTCCC
ATTCTTCTCCC -> TTCTTCTCCCA
TTCTTCTCCCA -> TCTTCTCCCAT
TCTTCTCCCAT -> CTTCTCCCATC
CTTCTCCCATC -> TTCTCCCATCA
TTCTCCCATCA -> TCTCCCATCAG
TCTCCCATCAG -> CTCCCATCAGC
CTCCCATCAGC -> TCCCATCAGCC
TCCCATCAGCC -> CCCATCAGCCT
CCCATCAGCCT -> CCATCAGCCTC
CCATCAGCCTC -> CATCAGCCTCA
CATCAGCCTCA -> ATCAGCCTCAA
ATCAGCCTCAA -> TCAGCCTCAAA
TCAGCCTCAAA -> CAGCCTCAAAC
CAGCCTCAAAC -> AGCCTCAAACT
AGCCTCAAACT -> GCCTCAAACTC
GCCTCAAACTC -> CCTCAAACTCA
CCTCAAACTCA -> CTCAAACTCAC
CTCAAACTCAC -> TCAAACTCACC
TCAAACTCACC -> CAAACTCACCT
CAAACTCACCT -> AAACTCACCTA
AAACTCACCTA -> AACTCACCTAA
AACTCACCTAA -> ACTCACCTAAA
ACTCACCTAAA -> CTCACCTAAAA
CTCACCTAAAA -> TCACCTAAAAC
TCACCTAAAAC -> CACCTAAAACT
CACCTAAAACT -> ACCTAAAACTA
ACCTAAAACTA -> CCTAAAACTAC
CCTAAAACTAC -> CTAAAACTACC
CTAAAACTACC -> TAAAACTACCT
TAAAACTACCT -> AAAACTACCTT
AAAACTACCTT -> AAACTACCTTC
AAACTACCTTC -> AACTACCTTCG
AACTACCTTCG -> ACTACCTTCGA
ACTACCTTCGA -> CTACCTTCGAA
CTACCTTCGAA -> TACCTTCGAAA
TACCTTCGAAA -> ACCTTCGAAAC
ACCTTCGAAAC -> CCTTCGAAACC
CCTTCGAAACC -> CTTCGAAACCG
CTTCGAAACCG -> TTCGAAACCGC
TTCGAAACCGC -> TCGAAACCGCA
TCGAAACCGCA -> CGAAACCGCAG
CGAAACCGCAG -> GAAACCGCAGT
GAAACCGCAGT -> AAACCGCAGTT
AAACCGCAGTT -> AACCGCAGTTT
AACCGCAGTTT -> ACCGCAGTTTG
ACCGCAGTTTG -> CCGCAGTTTGT
CCGCAGTTTGT -> CGCAGTTTGTG
CGCAGTTTGTG -> GCAGTTTGTGA
GCAGTTTGTGA -> CAGTTTGTGAA
CAGTTTGTGAA -> AGTTTGTGAAT
AGTTTGTGAAT -> GTTTGTGAATA
GTTTGTGAATA -> TTTGTGAATAG
TTTGTGAATAG -> TTGTGAATAGG
TTGTGAATAGG -> TGTGAATAGGA
TGTGAATAGGA -> GTGAATAGGAC
GTGAATAGGAC -> TGAATAGGACC
TGAATAGGACC -> GAATAGGACCA
GAATAGGACCA -> AATAGGACCAA
AATAGGACCAA -> ATAGGACCAAA
ATAGGACCAAA -> TAGGACCAAAA
TAGGACCAAAA -> AGGACCAAAAA
AGGACCAAAAA -> GGACCAAAAAT
GGACCAAAAAT -> GACCAAAAATG
GACCAAAAATG -> ACCAAAAATGA
ACCAAAAATGA -> CCAAAAATGAA
CCAAAAATGAA -> CAAAAATGAAT
CAAAAATGAAT -> AAAAATGAATG
AAAAATGAATG -> AAAATGAATGA
AAAATGAATGA -> AAATGAATGAA
AAATGAATGAA -> AATGAATGAAT
AATGAATGAAT -> ATGAATGAATT
ATGAATGAATT -> TGAATGAATTA
TGAATGAATTA -> GAATGAATTAG
GAATGAATTAG -> AATGAATTAGA
AATGAATTAGA -> ATGAATTAGAT,ATGAATTAGAC
ATGAATTAGAT -> TGAATTAGATA
TGAATTAGATA -> GAATTAGATAC
GAATTAGATAC -> AATTAGATACT
AATTAGATACT -> ATTAGATACTT
ATTAGATACTT -> TTAGATACTTG
TTAGATACTTG -> TAGATACTTGA
TAGATACTTGA -> AGATACTTGAT
AGATACTTGAT -> GATACTTGATG
GATACTTGATG -> ATACTTGATGG
ATACTTGATGG -> TACTTGATGGG
TACTTGATGGG -> ACTTGATGGGG
ACTTGATGGGG -> CTTGATGGGGT
CTTGATGGGGT -> TTGATGGGGTT
TTGATGGGGTT -> TGATGGGGTTC
TGATGGGGTTC -> GATGGGGTTCG
GATGGGGTTCG -> ATGGGGTTCGG
ATGGGGTTCGG -> TGGGGTTCGGC
TGGGGTTCGGC -> GGGGTTCGGCC
GGGGTTCGGCC -> GGGTTCGGCCG
GGGTTCGGCCG -> GGTTCGGCCGT
GGTTCGGCCGT -> GTTCGGCCGTG
GTTCGGCCGTG -> TTCGGCCGTGC
TTCGGCCGTGC -> TCGGCCGTGCC
TCGGCCGTGCC -> CGGCCGTGCCA
CGGCCGTGCCA -> GGCCGTGCCAC
GGCCGTGCCAC -> GCCGTGCCACT
GCCGTGCCACT -> CCGTGCCACTC
CCGTGCCACTC -> CGTGCCACTCG
CGTGCCACTCG -> GTGCCACTCGT
GTGCCACTCGT -> TGCCACTCGTC
TGCCACTCGTC -> GCCACTCGTCA
GCCACTCGTCA -> CCACTCGTCAT
CCACTCGTCAT -> CACTCGTCATC
CACTCGTCATC -> ACTCGTCATCC
ACTCGTCATCC -> CTCGTCATCCG
CTCGTCATCCG -> TCGTCATCCGG
TCGTCATCCGG -> CGTCATCCGGT
CGTCATCCGGT -> GTCATCCGGTT
GTCATCCGGTT -> TCATCCGGTTT
TCATCCGGTTT -> CATCCGGTTTA
CATCCGGTTTA -> ATCCGGTTTAC
ATCCGGTTTAC -> TCCGGTTTACG
TCCGGTTTACG -> CCGGTTTACGA
CCGGTTTACGA -> CGGTTTACGAA
CGGTTTACGAA -> GGTTTACGAAT
GGTTTACGAAT -> GTTTACGAATG
GTTTACGAATG -> TTTACGAATGT
TTTACGAATGT -> TTACGAATGTG
TTACGAATGTG -> TACGAATGTGA
TACGAATGTGA -> ACGAATGTGAA
ACGAATGTGAA -> CGAATGTGAAG
CGAATGTGAAG -> GAATGTGAAGC
GAATGTGAAGC -> AATGTGAAGCT
AATGTGAAGCT -> ATGTGAAGCTG
ATGTGAAGCTG -> TGTGAAGCTGA
TGTGAAGCTGA -> GTGAAGCTGAG
GTGAAGCTGAG -> TGAAGCTGAGG
TGAAGCTGAGG -> GAAGCTGAGGT
GAAGCTGAGGT -> AAGCTGAGGTT
AAGCTGAGGTT -> AGCTGAGGTTG
AGCTGAGGTTG -> GCTGAGGTTGC
GCTGAGGTTGC -> CTGAGGTTGCA
CTGAGGTTGCA -> TGAGGTTGCAC
TGAGGTTGCAC -> GAGGTTGCACC
GAGGTTGCACC -> AGGTTGCACCG
AGGTTGCACCG -> GGTTGCACCGA
GGTTGCACCGA -> GTTGCACCGAG
GTTGCACCGAG -> TTGCACCGAGA
TTGCACCGAGA -> TGCACCGAGAT
TGCACCGAGAT -> GCACCGAGATG
GCACCGAGATG -> CACCGAGATGT
CACCGAGATGT -> ACCGAGATGTG
ACCGAGATGTG -> CCGAGATGTGA
CCGAGATGTGA -> CGAGATGTGAC
CGAGATGTGAC -> GAGATGTGACA
GAGATGTGACA -> AGATGTGACAA
AGATGTGACAA -> GATGTGACAAT
GATGTGACAAT -> ATGTGACAATC
ATGTGACAATC -> TGTGACAATCG
TGTGACAATCG -> GTGACAATCGG
GTGACAATCGG -> TGACAATCGGT
TGACAATCGGT -> GACAATCGGTA
GACAATCGGTA -> ACAATCGGTAC
ACAATCGGTAC -> CAATCGGTACT
CAATCGGTACT -> AATCGGTACTC
AATCGGTACTC -> ATCGGTACTCA
ATCGGTACTCA -> TCGGTACTCAA
TCGGTACTCAA -> CGGTACTCAAC
CGGTACTCAAC -> GGTACTCAACT
GGTACTCAACT -> GTACTCAACTA
GTACTCAACTA -> TACTCAACTAG
TACTCAACTAG -> ACTCAACTAGC
ACTCAACTAGC -> CTCAACTAGCG
CTCAACTAGCG -> TCAACTAGCGT
TCAACTAGCGT -> CAACTAGCGTC
CAACTAGCGTC -> AACTAGCGTCC
AACTAGCGTCC -> ACTAGCGTCCA
ACTAGCGTCCA -> CTAGCGTCCAC
CTAGCGTCCAC -> TAGCGTCCACC
TAGCGTCCACC -> AGCGTCCACCC
AGCGTCCACCC -> GCGTCCACCCA
GCGTCCACCCA -> CGTCCACCCAC
CGTCCACCCAC -> GTCCACCCACA
GTCCACCCACA -> TCCACCCACAG
TCCACCCACAG -> CCACCCACAGT
CCACCCACAGT -> CACCCACAGTT
CACCCACAGTT -> ACCCACAGTTT
ACCCACAGTTT -> CCCACAGTTTC
CCCACAGTTTC -> CCACAGTTTCC
CCACAGTTTCC -> CACAGTTTCCA
CACAGTTTCCA -> ACAGTTTCCAG
ACAGTTTCCAG -> CAGTTTCCAGT
CAGTTTCCAGT -> AGTTTCCAGTA
AGTTTCCAGTA -> GTTTCCAGTAC
GTTTCCAGTAC -> TTTCCAGTACA
TTTCCAGTACA -> TTCCAGTACAC
TTCCAGTACAC -> TCCAGTACACC
TCCAGTACACC -> CCAGTACACCA
CCAGTACACCA -> CAGTACACCAT
CAGTACACCAT -> AGTACACCATA
AGTACACCATA -> GTACACCATAG
GTACACCATAG -> TACACCATAGA
TACACCATAGA -> ACACCATAGAG
ACACCATAGAG -> CACCATAGAGA
CACCATAGAGA -> ACCATAGAGAC
ACCATAGAGAC -> CCATAGAGACC
CCATAGAGACC -> CATAGAGACCT
CATAGAGACCT -> ATAGAGACCTC
ATAGAGACCTC -> TAGAGACCTCC
TAGAGACCTCC -> AGAGACCTCCG
AGAGACCTCCG -> GAGACCTCCGA
GAGACCTCCGA -> AGACCTCCGAA
AGACCTCCGAA -> GACCTCCGAAT
GACCTCCGAAT -> ACCTCCGAATC
ACCTCCGAATC -> CCTCCGAATCT
CCTCCGAATCT -> CTCCGAATCTC
CTCCGAATCTC -> TCCGAATCTCT
TCCGAATCTCT -> CCGAATCTCTT
CCGAATCTCTT -> CGAATCTCTTG
CGAATCTCTTG -> GAATCTCTTGT
GAATCTCTTGT -> AATCTCTTGTA
AATCTCTTGTA -> ATCTCTTGTAT
ATCTCTTGTAT -> TCTCTTGTATC
TCTCTTGTATC -> CTCTTGTATCC
CTCTTGTATCC -> TCTTGTATCCG
TCTTGTATCCG -> CTTGTATCCGG
CTTGTATCCGG -> TTGTATCCGGC
TTGTATCCGGC -> TGTATCCGGCA
TGTATCCGGCA -> GTATCCGGCAT
GTATCCGGCAT -> TATCCGGCATA
TATCCGGCATA -> ATCCGGCATAA
ATCCGGCATAA -> TCCGGCATAAA
TCCGGCATAAA -> CCGGCATAAAT
CCGGCATAAAT -> CGGCATAAATT
CGGCATAAATT -> GGCATAAATTT
GGCATAAATTT -> GCATAAATTTT
GCATAAATTTT -> CATAAATTTTT
CATAAATTTTT -> ATAAATTTTTT
ATAAATTTTTT -> TAAATTTTTTG
TAAATTTTTTG -> AAATTTTTTGG
AAATTTTTTGG -> AATTTTTTGGT
AATTTTTTGGT -> ATTTTTTGGTC
ATTTTTTGGTC -> TTTTTTGGTCG
TTTTTTGGTCG -> TTTTTGGTCGC
TTTTTGGTCGC -> TTTTGGTCGCT
TTTTGGTCGCT -> TTTGGTCGCTT
TTTGGTCGCTT -> TTGGTCGCTTA
TTGGTCGCTTA -> TGGTCGCTTAC
TGGTCGCTTAC -> GGTCGCTTACG
GGTCGCTTACG -> GTCGCTTACGT
GTCGCTTACGT -> TCGCTTACGTC
TCGCTTACGTC -> CGCTTACGTCC
CGCTTACGTCC -> GCTTACGTCCA
GCTTACGTCCA -> CTTACGTCCAT
CTTACGTCCAT -> TTACGTCCATA
TTACGTCCATA -> TACGTCCATAC
TACGTCCATAC -> ACGTCCATACG
ACGTCCATACG -> CGTCCATACGT
CGTCCATACGT -> GTCCATACGTG
GTCCATACGTG -> TCCATACGTGC
TCCATACGTGC -> CCATACGTGCT
CCATACGTGCT -> CATACGTGCTG
CATACGTGCTG -> ATACGTGCTGT
ATACGTGCTGT -> TACGTGCTGTA
TACGTGCTGTA -> ACGTGCTGTAG
ACGTGCTGTAG -> CGTGCTGTAGA
CGTGCTGTAGA -> GTGCTGTAGAT
GTGCTGTAGAT -> TGCTGTAGATA
TGCTGTAGATA -> GCTGTAGATAT
GCTGTAGATAT -> CTGTAGATATT
CTGTAGATATT -> TGTAGATATTA
TGTAGATATTA -> GTAGATATTAC
GTAGATATTAC -> TAGATATTACG
TAGATATTACG -> AGATATTACGC
AGATATTACGC -> GATATTACGCG
GATATTACGCG -> ATATTACGCGT
ATATTACGCGT -> TATTACGCGTT
TATTACGCGTT -> ATTACGCGTTC
ATTACGCGTTC -> TTACGCGTTCT
TTACGCGTTCT -> TACGCGTTCTC
TACGCGTTCTC -> ACGCGTTCTCT
ACGCGTTCTCT -> CGCGTTCTCTG
CGCGTTCTCTG -> GCGTTCTCTGC
GCGTTCTCTGC -> CGTTCTCTGCG
CGTTCTCTGCG -> GTTCTCTGCGC
GTTCTCTGCGC -> TTCTCTGCGCA
TTCTCTGCGCA -> TCTCTGCGCAG
TCTCTGCGCAG -> CTCTGCGCAGC
CTCTGCGCAGC -> TCTGCGCAGCT
TCTGCGCAGCT -> CTGCGCAGCTT
CTGCGCAGCTT -> TGCGCAGCTTA
TGCGCAGCTTA -> GCGCAGCTTAC
GCGCAGCTTAC -> CGCAGCTTACC
CGCAGCTTACC -> GCAGCTTACCG
GCAGCTTACCG -> CAGCTTACCGG
CAGCTTACCGG -> AGCTTACCGGC
AGCTTACCGGC -> GCTTACCGGCG
GCTTACCGGCG -> CTTACCGGCGA
CTTACCGGCGA -> TTACCGGCGAA
TTACCGGCGAA -> TACCGGCGAAA
TACCGGCGAAA -> ACCGGCGAAAC
ACCGGCGAAAC -> CCGGCGAAACT
CCGGCGAAACT -> CGGCGAAACTG
CGGCGAAACTG -> GGCGAAACTGT
GGCGAAACTGT -> GCGAAACTGTA
GCGAAACTGTA -> CGAAACTGTAA
CGAAACTGTAA -> GAAACTGTAAT
GAAACTGTAAT -> AAACTGTAATA
AAACTGTAATA -> AACTGTAATAT
AACTGTAATAT -> ACTGTAATATC
ACTGTAATATC -> CTGTAATATCA
CTGTAATATCA -> TGTAATATCAG
TGTAATATCAG -> GTAATATCAGC
GTAATATCAGC -> TAATATCAGCG
TAATATCAGCG -> AATATCAGCGG
AATATCAGCGG -> ATATCAGCGGG
ATATCAGCGGG -> TATCAGCGGGT
TATCAGCGGGT -> ATCAGCGGGTA
ATCAGCGGGTA -> TCAGCGGGTAG
TCAGCGGGTAG -> CAGCGGGTAGT
CAGCGGGTAGT -> AGCGGGTAGTT
AGCGGGTAGTT -> GCGGGTAGTTG
GCGGGTAGTTG -> CGGGTAGTTGT
CGGGTAGTTGT -> GGGTAGTTGTG
GGGTAGTTGTG -> GGTAGTTGTGG
GGTAGTTGTGG -> GTAGTTGTGGG
GTAGTTGTGGG -> TAGTTGTGGGG
TAGTTGTGGGG -> AGTTGTGGGGT
AGTTGTGGGGT -> GTTGTGGGGTG
GTTGTGGGGTG -> TTGTGGGGTGC
TTGTGGGGTGC -> TGTGGGGTGCT
TGTGGGGTGCT -> GTGGGGTGCTG
GTGGGGTGCTG -> TGGGGTGCTGC
TGGGGTGCTGC -> GGGGTGCTGCG
GGGGTGCTGCG -> GGGTGCTGCGC
GGGTGCTGCGC -> GGTGCTGCGCG
GGTGCTGCGCG -> GTGCTGCGCGG
GTGCTGCGCGG -> TGCTGCGCGGT
TGCTGCGCGGT -> GCTGCGCGGTG
GCTGCGCGGTG -> CTGCGCGGTGG
CTGCGCGGTGG -> TGCGCGGTGGG
TGCGCGGTGGG -> GCGCGGTGGGA
GCGCGGTGGGA -> CGCGGTGGGAC
CGCGGTGGGAC -> GCGGTGGGACC
GCGGTGGGACC -> CGGTGGGACCG
CGGTGGGACCG -> GGTGGGACCGT
GGTGGGACCGT -> GTGGGACCGTT
GTGGGACCGTT -> TGGGACCGTTA
TGGGACCGTTA -> GGGACCGTTAT
GGGACCGTTAT -> GGACCGTTATG
GGACCGTTATG -> GACCGTTATGT
GACCGTTATGT -> ACCGTTATGTG
ACCGTTATGTG -> CCGTTATGTGG
CCGTTATGTGG -> CGTTATGTGGC
CGTTATGTGGC -> GTTATGTGGCG
GTTATGTGGCG -> TTATGTGGCGG
TTATGTGGCGG -> TATGTGGCGGA
TATGTGGCGGA -> ATGTGGCGGAA
ATGTGGCGGAA -> TGTGGCGGAAA
TGTGGCGGAAA -> GTGGCGGAAAA
GTGGCGGAAAA -> TGGCGGAAAAG
TGGCGGAAAAG -> GGCGGAAAAGT
GGCGGAAAAGT -> GCGGAAAAGTG
GCGGAAAAGTG -> CGGAAAAGTGG
CGGAAAAGTGG -> GGAAAAGTGGT
GGAAAAGTGGT -> GAAAAGTGGTT
GAAAAGTGGTT -> AAAAGTGGTTC
AAAAGTGGTTC -> AAAGTGGTTCC
AAAGTGGTTCC -> AAGTGGTTCCG
AAGTGGTTCCG -> AGTGGTTCCGG
AGTGGTTCCGG -> GTGGTTCCGGG
GTGGTTCCGGG -> TGGTTCCGGGG
TGGTTCCGGGG -> GGTTCCGGGGG
GGTTCCGGGGG -> GTTCCGGGGGG
GTTCCGGGGGG -> TTCCGGGGGGC
TTCCGGGGGGC -> TCCGGGGGGCA
TCCGGGGGGCA -> CCGGGGGGCAA
CCGGGGGGCAA -> CGGGGGGCAAA
CGGGGGGCAAA -> GGGGGGCAAAT
GGGGGGCAAAT -> GGGGGCAAATT
GGGGGCAAATT -> GGGGCAAATTG
GGGGCAAATTG -> GGGCAAATTGA
GGGCAAATTGA -> GGCAAATTGAC
GGCAAATTGAC -> GCAAATTGACA
GCAAATTGACA -> CAAATTGACAG
CAAATTGACAG -> AAATTGACAGC
AAATTGACAGC -> AATTGACAGCT
AATTGACAGCT -> ATTGACAGCTC
ATTGACAGCTC -> TTGACAGCTCC
TTGACAGCTCC -> TGACAGCTCCA
TGACAGCTCCA -> GACAGCTCCAG
GACAGCTCCAG -> ACAGCTCCAGA
ACAGCTCCAGA -> CAGCTCCAGAT
CAGCTCCAGAT -> AGCTCCAGATC
AGCTCCAGATC -> GCTCCAGATCT
GCTCCAGATCT -> CTCCAGATCTA
CTCCAGATCTA -> TCCAGATCTAC
TCCAGATCTAC -> CCAGATCTACG
CCAGATCTACG -> CAGATCTACGA
CAGATCTACGA -> AGATCTACGAA
AGATCTACGAA -> GATCTACGAAC
GATCTACGAAC -> ATCTACGAACT
ATCTACGAACT -> TCTACGAACTG
TCTACGAACTG -> CTACGAACTGG
CTACGAACTGG -> TACGAACTGGC
TACGAACTGGC -> ACGAACTGGCT
ACGAACTGGCT -> CGAACTGGCTT
CGAACTGGCTT -> GAACTGGCTTA
GAACTGGCTTA -> AACTGGCTTAA
AACTGGCTTAA -> ACTGGCTTAAG
ACTGGCTTAAG -> CTGGCTTAAGG
CTGGCTTAAGG -> TGGCTTAAGGT
TGGCTTAAGGT -> GGCTTAAGGTC
GGCTTAAGGTC -> GCTTAAGGTCT
GCTTAAGGTCT -> CTTAAGGTCTG
CTTAAGGTCTG -> TTAAGGTCTGC
TTAAGGTCTGC -> TAAGGTCTGCC
TAAGGTCTGCC -> AAGGTCTGCCT
AAGGTCTGCCT -> AGGTCTGCCTA
AGGTCTGCCTA -> GGTCTGCCTAA
GGTCTGCCTAA -> GTCTGCCTAAA
GTCTGCCTAAA -> TCTGCCTAAAT
TCTGCCTAAAT -> CTGCCTAAATG
CTGCCTAAATG -> TGCCTAAATGA
TGCCTAAATGA -> GCCTAAATGAA
GCCTAAATGAA -> CCTAAATGAAT
CCTAAATGAAT -> CTAAATGAATT
CTAAATGAATT -> TAAATGAATTA
TAAATGAATTA -> AAATGAATTAG
AAATGAATTAG -> AATGAATTAGA
ATGAATTAGAC -> TGAATTAGACC
TGAATTAGACC -> GAATTAGACCC
GAATTAGACCC -> AATTAGACCCT
AATTAGACCCT -> ATTAGACCCTC
ATTAGACCCTC -> TTAGACCCTCT
TTAGACCCTCT -> TAGACCCTCTG
TAGACCCTCTG -> AGACCCTCTGG
AGACCCTCTGG -> GACCCTCTGGG
GACCCTCTGGG -> ACCCTCTGGGC
ACCCTCTGGGC -> CCCTCTGGGCA
CCCTCTGGGCA -> CCTCTGGGCAG
CCTCTGGGCAG -> CTCTGGGCAGG
CTCTGGGCAGG -> TCTGGGCAGGG
TCTGGGCAGGG -> CTGGGCAGGGG
CTGGGCAGGGG -> TGGGCAGGGGC
TGGGCAGGGGC -> GGGCAGGGGCG
GGGCAGGGGCG -> GGCAGGGGCGA
GGCAGGGGCGA -> GCAGGGGCGAC
GCAGGGGCGAC -> CAGGGGCGACC
CAGGGGCGACC -> AGGGGCGACCC
AGGGGCGACCC -> GGGGCGACCCG
GGGGCGACCCG -> GGGCGACCCGT
GGGCGACCCGT -> GGCGACCCGTG
GGCGACCCGTG -> GCGACCCGTGT
GCGACCCGTGT -> CGACCCGTGTA
CGACCCGTGTA -> GACCCGTGTAC
GACCCGTGTAC -> ACCCGTGTACC
ACCCGTGTACC -> CCCGTGTACCG
CCCGTGTACCG -> CCGTGTACCGG
CCGTGTACCGG -> CGTGTACCGGA
CGTGTACCGGA -> GTGTACCGGAT
GTGTACCGGAT -> TGTACCGGATG
TGTACCGGATG -> GTACCGGATGG
GTACCGGATGG -> TACCGGATGGT
TACCGGATGGT -> ACCGGATGGTA
ACCGGATGGTA -> CCGGATGGTAC
CCGGATGGTAC -> CGGATGGTACC
CGGATGGTACC -> GGATGGTACCC
GGATGGTACCC -> GATGGTACCCT
GATGGTACCCT -> ATGGTACCCTT
ATGGTACCCTT -> TGGTACCCTTA
TGGTACCCTTA -> GGTACCCTTAA
GGTACCCTTAA -> GTACCCTTAAC
GTACCCTTAAC -> TACCCTTAACA
TACCCTTAACA -> ACCCTTAACAA
ACCCTTAACAA -> CCCTTAACAAG
CCCTTAACAAG -> CCTTAACAAGT
CCTTAACAAGT -> CTTAACAAGTG
CTTAACAAGTG -> TTAACAAGTGC
TTAACAAGTGC -> TAACAAGTGCG
TAACAAGTGCG -> AACAAGTGCGG
AACAAGTGCGG -> ACAAGTGCGGG
ACAAGTGCGGG -> CAAGTGCGGGC
CAAGTGCGGGC -> AAGTGCGGGCG
AAGTGCGGGCG -> AGTGCGGGCGA
AGTGCGGGCGA -> GTGCGGGCGAT
GTGCGGGCGAT -> TGCGGGCGATC
TGCGGGCGATC -> GCGGGCGATCA
GCGGGCGATCA -> CGGGCGATCAG
CGGGCGATCAG -> GGGCGATCAGA
GGGCGATCAGA -> GGCGATCAGAG
GGCGATCAGAG -> GCGATCAGAGC
GCGATCAGAGC -> CGATCAGAGCG
CGATCAGAGCG -> GATCAGAGCGC
GATCAGAGCGC -> ATCAGAGCGCC
ATCAGAGCGCC -> TCAGAGCGCCT
TCAGAGCGCCT -> CAGAGCGCCTT
CAGAGCGCCTT -> AGAGCGCCTTG
AGAGCGCCTTG -> GAGCGCCTTGC
GAGCGCCTTGC -> AGCGCCTTGCA
AGCGCCTTGCA -> GCGCCTTGCAC
GCGCCTTGCAC -> CGCCTTGCACA
CGCCTTGCACA -> GCCTTGCACAC
GCCTTGCACAC -> CCTTGCACACG
CCTTGCACACG -> CTTGCACACGC
CTTGCACACGC -> TTGCACACGCG
TTGCACACGCG -> TGCACACGCGA
TGCACACGCGA -> GCACACGCGAC
GCACACGCGAC -> CACACGCGACG
CACACGCGACG -> ACACGCGACGG
ACACGCGACGG -> CACGCGACGGT
CACGCGACGGT -> ACGCGACGGTT
ACGCGACGGTT -> CGCGACGGTTC
CGCGACGGTTC -> GCGACGGTTCC
GCGACGGTTCC -> CGACGGTTCCG
CGACGGTTCCG -> GACGGTTCCGG
GACGGTTCCGG -> ACGGTTCCGGA
ACGGTTCCGGA -> CGGTTCCGGAC
CGGTTCCGGAC -> GGTTCCGGACA
GGTTCCGGACA -> GTTCCGGACAC
GTTCCGGACAC -> TTCCGGACACC
TTCCGGACACC -> TCCGGACACCG
TCCGGACACCG -> CCGGACACCGG
CCGGACACCGG -> CGGACACCGGC
CGGACACCGGC -> GGACACCGGCG
GGACACCGGCG -> GACACCGGCGA
GACACCGGCGA -> ACACCGGCGAA
ACACCGGCGAA -> CACCGGCGAAG
CACCGGCGAAG -> ACCGGCGAAGT
ACCGGCGAAGT -> CCGGCGAAGTC
CCGGCGAAGTC -> CGGCGAAGTCC
CGGCGAAGTCC -> GGCGAAGTCCT
GGCGAAGTCCT -> GCGAAGTCCTG
GCGAAGTCCTG -> CGAAGTCCTGA
CGAAGTCCTGA -> GAAGTCCTGAC
GAAGTCCTGAC -> AAGTCCTGACC
AAGTCCTGACC -> AGTCCTGACCT
AGTCCTGACCT -> GTCCTGACCTA
GTCCTGACCTA -> TCCTGACCTAG
TCCTGACCTAG -> CCTGACCTAGT
CCTGACCTAGT -> CTGACCTAGTG
CTGACCTAGTG -> TGACCTAGTGG
TGACCTAGTGG -> GACCTAGTGGT
GACCTAGTGGT -> ACCTAGTGGTG
ACCTAGTGGTG -> CCTAGTGGTGA
CCTAGTGGTGA -> CTAGTGGTGAG
CTAGTGGTGAG -> TAGTGGTGAGG
TAGTGGTGAGG -> AGTGGTGAGGT
AGTGGTGAGGT -> GTGGTGAGGTA
GTGGTGAGGTA -> TGGTGAGGTAC
TGGTGAGGTAC -> GGTGAGGTACG
GGTGAGGTACG -> GTGAGGTACGG
GTGAGGTACGG -> TGAGGTACGGT
TGAGGTACGGT -> GAGGTACGGTC
GAGGTACGGTC -> AGGTACGGTCG
AGGTACGGTCG -> GGTACGGTCGC
GGTACGGTCGC -> GTACGGTCGCA
GTACGGTCGCA -> TACGGTCGCAG
TACGGTCGCAG -> ACGGTCGCAGC
ACGGTCGCAGC -> CGGTCGCAGCG
CGGTCGCAGCG -> GGTCGCAGCGT
GGTCGCAGCGT -> GTCGCAGCGTC
GTCGCAGCGTC -> TCGCAGCGTCA
TCGCAGCGTCA -> CGCAGCGTCAC
CGCAGCGTCAC -> GCAGCGTCACA
GCAGCGTCACA -> CAGCGTCACAT
CAGCGTCACAT -> AGCGTCACATT
AGCGTCACATT -> GCGTCACATTT
GCGTCACATTT -> CGTCACATTTA
CGTCACATTTA -> GTCACATTTAA
GTCACATTTAA -> TCACATTTAAC
TCACATTTAAC -> CACATTTAACC
CACATTTAACC -> ACATTTAACCC
ACATTTAACCC -> CATTTAACCCC
CATTTAACCCC -> ATTTAACCCCG
ATTTAACCCCG -> TTTAACCCCGC
TTTAACCCCGC -> TTAACCCCGCG
TTAACCCCGCG -> TAACCCCGCGT
TAACCCCGCGT -> AACCCCGCGTA
AACCCCGCGTA -> ACCCCGCGTAC
ACCCCGCGTAC -> CCCCGCGTACT
CCCCGCGTACT -> CCCGCGTACTC
CCCGCGTACTC -> CCGCGTACTCG
CCGCGTACTCG -> CGCGTACTCGA
CGCGTACTCGA -> GCGTACTCGAC
GCGTACTCGAC -> CGTACTCGACT
CGTACTCGACT -> GTACTCGACTT
GTACTCGACTT -> TACTCGACTTA
TACTCGACTTA -> ACTCGACTTAT
ACTCGACTTAT -> CTCGACTTATA
CTCGACTTATA -> TCGACTTATAG
TCGACTTATAG -> CGACTTATAGG
CGACTTATAGG -> GACTTATAGGG
GACTTATAGGG -> ACTTATAGGGG
ACTTATAGGGG -> CTTATAGGGGA
CTTATAGGGGA -> TTATAGGGGAT
TTATAGGGGAT -> TATAGGGGATA
TATAGGGGATA -> ATAGGGGATAC
ATAGGGGATAC -> TAGGGGATACC
TAGGGGATACC -> AGGGGATACCC
AGGGGATACCC -> GGGGATACCCC
GGGGATACCCC -> GGGATACCCCT
GGGATACCCCT -> GGATACCCCTC
GGATACCCCTC -> GATACCCCTCT
GATACCCCTCT -> ATACCCCTCTA
ATACCCCTCTA -> TACCCCTCTAT
TACCCCTCTAT -> ACCCCTCTATA
ACCCCTCTATA -> CCCCTCTATAT
CCCCTCTATAT -> CCCTCTATATC
CCCTCTATATC -> CCTCTATATCA
CCTCTATATCA -> CTCTATATCAG
CTCTATATCAG -> TCTATATCAGC
TCTATATCAGC -> CTATATCAGCA
CTATATCAGCA -> TATATCAGCAA
TATATCAGCAA -> ATATCAGCAAC
ATATCAGCAAC -> TATCAGCAACT
TATCAGCAACT -> ATCAGCAACTT
ATCAGCAACTT -> TCAGCAACTTT
TCAGCAACTTT -> CAGCAACTTTG
CAGCAACTTTG -> AGCAACTTTGG
AGCAACTTTGG -> GCAACTTTGGA
GCAACTTTGGA -> CAACTTTGGAT
CAACTTTGGAT -> AACTTTGGATC
AACTTTGGATC -> ACTTTGGATCC
ACTTTGGATCC -> CTTTGGATCCA
CTTTGGATCCA -> TTTGGATCCAT
TTTGGATCCAT -> TTGGATCCATC
TTGGATCCATC -> TGGATCCATCG
TGGATCCATCG -> GGATCCATCGA
GGATCCATCGA -> GATCCATCGAT
GATCCATCGAT -> ATCCATCGATT
ATCCATCGATT -> TCCATCGATTC
TCCATCGATTC -> CCATCGATTCC
CCATCGATTCC -> CATCGATTCCT
CATCGATTCCT -> ATCGATTCCTC
ATCGATTCCTC -> TCGATTCCTCC
TCGATTCCTCC -> CGATTCCTCCC
CGATTCCTCCC -> GATTCCTCCCG
GATTCCTCCCG -> ATTCCTCCCGA
ATTCCTCCCGA -> TTCCTCCCGAC
TTCCTCCCGAC -> TCCTCCCGACC
TCCTCCCGACC -> CCTCCCGACCC
CCTCCCGACCC -> CTCCCGACCCT
CTCCCGACCCT -> TCCCGACCCTC
TCCCGACCCTC -> CCCGACCCTCA
CCCGACCCTCA -> CCGACCCTCAT
CCGACCCTCAT -> CGACCCTCATT
CGACCCTCATT -> GACCCTCATTT
GACCCTCATTT -> ACCCTCATTTT
ACCCTCATTTT -> CCCTCATTTTA
CCCTCATTTTA -> CCTCATTTTAT
CCTCATTTTAT -> CTCATTTTATC
CTCATTTTATC -> TCATTTTATCG
TCATTTTATCG -> CATTTTATCGG
CATTTTATCGG -> ATTTTATCGGC
ATTTTATCGGC -> TTTTATCGGCC
TTTTATCGGCC -> TTTATCGGCCC
TTTATCGGCCC -> TTATCGGCCCG
TTATCGGCCCG -> TATCGGCCCGT
TATCGGCCCGT -> ATCGGCCCGTG
ATCGGCCCGTG -> TCGGCCCGTGG
TCGGCCCGTGG -> CGGCCCGTGGA
CGGCCCGTGGA -> GGCCCGTGGAA
GGCCCGTGGAA -> GCCCGTGGAAT
GCCCGTGGAAT -> CCCGTGGAATG
CCCGTGGAATG -> CCGTGGAATGA
CCGTGGAATGA -> CGTGGAATGAC
CGTGGAATGAC -> GTGGAATGACT
GTGGAATGACT -> TGGAATGACTG
TGGAATGACTG -> GGAATGACTGT
GGAATGACTGT -> GAATGACTGTA
GAATGACTGTA -> AATGACTGTAC
AATGACTGTAC -> ATGACTGTACG
ATGACTGTACG -> TGACTGTACGG
TGACTGTACGG -> GACTGTACGGG
GACTGTACGGG -> ACTGTACGGGA
ACTGTACGGGA -> CTGTACGGGAC
CTGTACGGGAC -> TGTACGGGACC
TGTACGGGACC -> GTACGGGACCG
GTACGGGACCG -> TACGGGACCGG
TACGGGACCGG -> ACGGGACCGGG
ACGGGACCGGG -> CGGGACCGGGG
CGGGACCGGGG -> GGGACCGGGGT
GGGACCGGGGT -> GGACCGGGGTG
GGACCGGGGTG -> GACCGGGGTGC
GACCGGGGTGC -> ACCGGGGTGCC
ACCGGGGTGCC -> CCGGGGTGCCA
CCGGGGTGCCA -> CGGGGTGCCAG
CGGGGTGCCAG -> GGGGTGCCAGG
GGGGTGCCAGG -> GGGTGCCAGGT
GGGTGCCAGGT -> GGTGCCAGGTA
GGTGCCAGGTA -> GTGCCAGGTAC
GTGCCAGGTAC -> TGCCAGGTACG
TGCCAGGTACG -> GCCAGGTACGA
GCCAGGTACGA -> CCAGGTACGAA
CCAGGTACGAA -> CAGGTACGAAC
CAGGTACGAAC -> AGGTACGAACG
AGGTACGAACG -> GGTACGAACGG
GGTACGAACGG -> GTACGAACGGA
GTACGAACGGA -> TACGAACGGAA
TACGAACGGAA -> ACGAACGGAAG
ACGAACGGAAG -> CGAACGGAAGC
CGAACGGAAGC -> GAACGGAAGCT
GAACGGAAGCT -> AACGGAAGCTA
AACGGAAGCTA -> ACGGAAGCTAG
ACGGAAGCTAG -> CGGAAGCTAGA
CGGAAGCTAGA -> GGAAGCTAGAT
GGAAGCTAGAT -> GAAGCTAGATC
GAAGCTAGATC -> AAGCTAGATCA
AAGCTAGATCA -> AGCTAGATCAA
AGCTAGATCAA -> GCTAGATCAAT
GCTAGATCAAT -> CTAGATCAATT
CTAGATCAATT -> TAGATCAATTC
TAGATCAATTC -> AGATCAATTCG
AGATCAATTCG -> GATCAATTCGC
GATCAATTCGC -> ATCAATTCGCC
ATCAATTCGCC -> TCAATTCGCCG
TCAATTCGCCG -> CAATTCGCCGG
CAATTCGCCGG -> AATTCGCCGGA
AATTCGCCGGA -> ATTCGCCGGAG
ATTCGCCGGAG -> TTCGCCGGAGG
TTCGCCGGAGG -> TCGCCGGAGGC
TCGCCGGAGGC -> CGCCGGAGGCG
CGCCGGAGGCG -> GCCGGAGGCGA
GCCGGAGGCGA -> CCGGAGGCGAG
CCGGAGGCGAG -> CGGAGGCGAGT
CGGAGGCGAGT -> GGAGGCGAGTC
GGAGGCGAGTC -> GAGGCGAGTCT
GAGGCGAGTCT -> AGGCGAGTCTA
AGGCGAGTCTA -> GGCGAGTCTAA
GGCGAGTCTAA -> GCGAGTCTAAC
GCGAGTCTAAC -> CGAGTCTAACC
CGAGTCTAACC -> GAGTCTAACCC
GAGTCTAACCC -> AGTCTAACCCG
AGTCTAACCCG -> GTCTAACCCGG
GTCTAACCCGG -> TCTAACCCGGT
TCTAACCCGGT -> CTAACCCGGTA
CTAACCCGGTA -> TAACCCGGTAT
TAACCCGGTAT -> AACCCGGTATA
AACCCGGTATA -> ACCCGGTATAG
ACCCGGTATAG -> CCCGGTATAGA
CCCGGTATAGA -> CCGGTATAGAG
CCGGTATAGAG -> CGGTATAGAGT
CGGTATAGAGT -> GGTATAGAGTC
GGTATAGAGTC -> GTATAGAGTCC
GTATAGAGTCC -> TATAGAGTCCT
TATAGAGTCCT -> ATAGAGTCCTG
ATAGAGTCCTG -> TAGAGTCCTGT
TAGAGTCCTGT -> AGAGTCCTGTC
AGAGTCCTGTC -> GAGTCCTGTCA
GAGTCCTGTCA -> AGTCCTGTCAA
AGTCCTGTCAA -> GTCCTGTCAAC
GTCCTGTCAAC -> TCCTGTCAACA
TCCTGTCAACA -> CCTGTCAACAG
CCTGTCAACAG -> CTGTCAACAGG
CTGTCAACAGG -> TGTCAACAGGG
TGTCAACAGGG -> GTCAACAGGGA
GTCAACAGGGA -> TCAACAGGGAT
TCAACAGGGAT -> CAACAGGGATG
CAACAGGGATG -> AACAGGGATGA
AACAGGGATGA -> ACAGGGATGAG
ACAGGGATGAG -> CAGGGATGAGT
CAGGGATGAGT -> AGGGATGAGTG
AGGGATGAGTG -> GGGATGAGTGA
GGGATGAGTGA -> GGATGAGTGAC
GGATGAGTGAC -> GATGAGTGACT
GATGAGTGACT -> ATGAGTGACTA
ATGAGTGACTA -> TGAGTGACTAT
TGAGTGACTAT -> GAGTGACTATG
GAGTGACTATG -> AGTGACTATGC
AGTGACTATGC -> GTGACTATGCT
GTGACTATGCT -> TGACTATGCTT
TGACTATGCTT -> GACTATGCTTA
GACTATGCTTA -> ACTATGCTTAC
ACTATGCTTAC -> CTATGCTTACC
CTATGCTTACC -> TATGCTTACCA
TATGCTTACCA -> ATGCTTACCAT
ATGCTTACCAT -> TGCTTACCATT
TGCTTACCATT -> GCTTACCATTA
GCTTACCATTA -> CTTACCATTAC
CTTACCATTAC -> TTACCATTACC
TTACCATTACC -> TACCATTACCA
TACCATTACCA -> ACCATTACCAG
ACCATTACCAG -> CCATTACCAGT
CCATTACCAGT -> CATTACCAGTA
CATTACCAGTA -> ATTACCAGTAC
ATTACCAGTAC -> TTACCAGTACG
TTACCAGTACG -> TACCAGTACGA
TACCAGTACGA -> ACCAGTACGAC
ACCAGTACGAC -> CCAGTACGACT
CCAGTACGACT -> CAGTACGACTA
CAGTACGACTA -> AGTACGACTAC
AGTACGACTAC -> GTACGACTACG
GTACGACTACG -> TACGACTACGA
TACGACTACGA -> ACGACTACGAC
ACGACTACGAC -> CGACTACGACA
CGACTACGACA -> GACTACGACAC
GACTACGACAC -> ACTACGACACC
ACTACGACACC -> CTACGACACCG
CTACGACACCG -> TACGACACCGA
TACGACACCGA -> ACGACACCGAG
ACGACACCGAG -> CGACACCGAGT
CGACACCGAGT -> GACACCGAGTT
GACACCGAGTT -> ACACCGAGTTT
ACACCGAGTTT -> CACCGAGTTTG
CACCGAGTTTG -> ACCGAGTTTGC
ACCGAGTTTGC -> CCGAGTTTGCT
CCGAGTTTGCT -> CGAGTTTGCTA
CGAGTTTGCTA -> GAGTTTGCTAC
GAGTTTGCTAC -> AGTTTGCTACA
AGTTTGCTACA -> GTTTGCTACAA
GTTTGCTACAA -> TTTGCTACAAC
TTTGCTACAAC -> TTGCTACAACG
TTGCTACAACG -> TGCTACAACGA
TGCTACAACGA -> GCTACAACGAC
GCTACAACGAC -> CTACAACGACG
CTACAACGACG -> TACAACGACGC
TACAACGACGC -> ACAACGACGCG
ACAACGACGCG -> CAACGACGCGA
CAACGACGCGA -> AACGACGCGAT
AACGACGCGAT -> ACGACGCGATC
ACGACGCGATC -> CGACGCGATCC
CGACGCGATCC -> GACGCGATCCT
GACGCGATCCT -> ACGCGATCCTA
ACGCGATCCTA -> CGCGATCCTAC
CGCGATCCTAC -> GCGATCCTACG
GCGATCCTACG -> CGATCCTACGA
CGATCCTACGA -> GATCCTACGAT
GATCCTACGAT -> ATCCTACGATA
ATCCTACGATA -> TCCTACGATAA
TCCTACGATAA -> CCTACGATAAT
CCTACGATAAT -> CTACGATAATA
CTACGATAATA -> TACGATAATAA
TACGATAATAA -> ACGATAATAAA
ACGATAATAAA -> CGATAATAAAA
CGATAATAAAA -> GATAATAAAAC
GATAATAAAAC -> ATAATAAAACC
ATAATAAAACC -> TAATAAAACCC
TAATAAAACCC -> AATAAAACCCC
AATAAAACCCC -> ATAAAACCCCG
ATAAAACCCCG -> TAAAACCCCGA
TAAAACCCCGA -> AAAACCCCGAT
AAAACCCCGAT -> AAACCCCGATA
AAACCCCGATA -> AACCCCGATAC
AACCCCGATAC -> ACCCCGATACA
ACCCCGATACA -> CCCCGATACAG
CCCCGATACAG -> CCCGATACAGC
CCCGATACAGC -> CCGATACAGCT
CCGATACAGCT -> CGATACAGCTT
CGATACAGCTT -> GATACAGCTTG
GATACAGCTTG -> ATACAGCTTGT
ATACAGCTTGT -> TACAGCTTGTG
TACAGCTTGTG -> ACAGCTTGTGT
ACAGCTTGTGT -> CAGCTTGTGTG
CAGCTTGTGTG -> AGCTTGTGTGA
AGCTTGTGTGA -> GCTTGTGTGAG
GCTTGTGTGAG -> CTTGTGTGAGA
CTTGTGTGAGA -> TTGTGTGAGAC
TTGTGTGAGAC -> TGTGTGAGACC
TGTGTGAGACC -> GTGTGAGACCG
GTGTGAGACCG -> TGTGAGACCGC
TGTGAGACCGC -> GTGAGACCGCA
GTGAGACCGCA -> TGAGACCGCAA
TGAGACCGCAA -> GAGACCGCAAA
GAGACCGCAAA -> AGACCGCAAAT
AGACCGCAAAT -> GACCGCAAATG
GACCGCAAATG -> ACCGCAAATGT
ACCGCAAATGT -> CCGCAAATGTC
CCGCAAATGTC -> CGCAAATGTCG
CGCAAATGTCG -> GCAAATGTCGT
GCAAATGTCGT -> CAAATGTCGTC
CAAATGTCGTC -> AAATGTCGTCA
AAATGTCGTCA -> AATGTCGTCAA
AATGTCGTCAA -> ATGTCGTCAAA
ATGTCGTCAAA -> TGTCGTCAAAC
TGTCGTCAAAC -> GTCGTCAAACA
GTCGTCAAACA -> TCGTCAAACAA
TCGTCAAACAA -> CGTCAAACAAT
CGTCAAACAAT -> GTCAAACAATG
GTCAAACAATG -> TCAAACAATGG
TCAAACAATGG -> CAAACAATGGA
CAAACAATGGA -> AAACAATGGAG
AAACAATGGAG -> AACAATGGAGT
AACAATGGAGT -> ACAATGGAGTC
ACAATGGAGTC -> CAATGGAGTCC
CAATGGAGTCC -> AATGGAGTCCG
AATGGAGTCCG -> ATGGAGTCCGC
ATGGAGTCCGC -> TGGAGTCCGCG
TGGAGTCCGCG -> GGAGTCCGCGC
GGAGTCCGCGC -> GAGTCCGCGCG
GAGTCCGCGCG -> AGTCCGCGCGC
AGTCCGCGCGC -> GTCCGCGCGCT
GTCCGCGCGCT -> TCCGCGCGCTC
TCCGCGCGCTC -> CCGCGCGCTCG
CCGCGCGCTCG -> CGCGCGCTCGT
CGCGCGCTCGT -> GCGCGCTCGTA
GCGCGCTCGTA -> CGCGCTCGTAC
CGCGCTCGTAC -> GCGCTCGTACT
GCGCTCGTACT -> CGCTCGTACTG
CGCTCGTACTG -> GCTCGTACTGG
GCTCGTACTGG -> CTCGTACTGGA
CTCGTACTGGA -> TCGTACTGGAT
TCGTACTGGAT -> CGTACTGGATC
CGTACTGGATC -> GTACTGGATCG
GTACTGGATCG -> TACTGGATCGG
TACTGGATCGG -> ACTGGATCGGA
ACTGGATCGGA -> CTGGATCGGAG
CTGGATCGGAG -> TGGATCGGAGC
TGGATCGGAGC -> GGATCGGAGCA
GGATCGGAGCA -> GATCGGAGCAG
GATCGGAGCAG -> ATCGGAGCAGC
ATCGGAGCAGC -> TCGGAGCAGCC
TCGGAGCAGCC -> CGGAGCAGCCA
CGGAGCAGCCA -> GGAGCAGCCAA
GGAGCAGCCAA -> GAGCAGCCAAC
GAGCAGCCAAC -> AGCAGCCAACA
AGCAGCCAACA -> GCAGCCAACAC
GCAGCCAACAC -> CAGCCAACACA
CAGCCAACACA -> AGCCAACACAA
AGCCAACACAA -> GCCAACACAAA
GCCAACACAAA -> CCAACACAAAT
CCAACACAAAT -> CAACACAAATC
CAACACAAATC -> AACACAAATCC
AACACAAATCC -> ACACAAATCCC
ACACAAATCCC -> CACAAATCCCT
CACAAATCCCT -> ACAAATCCCTT
ACAAATCCCTT -> CAAATCCCTTA
CAAATCCCTTA -> AAATCCCTTAC
AAATCCCTTAC -> AATCCCTTACC
AATCCCTTACC -> ATCCCTTACCT
ATCCCTTACCT -> TCCCTTACCTG
TCCCTTACCTG -> CCCTTACCTGC
CCCTTACCTGC -> CCTTACCTGCC
CCTTACCTGCC -> CTTACCTGCCG
CTTACCTGCCG -> TTACCTGCCGT
TTACCTGCCGT -> TACCTGCCGTT
TACCTGCCGTT -> ACCTGCCGTTT
ACCTGCCGTTT -> CCTGCCGTTTC
CCTGCCGTTTC -> CTGCCGTTTCG
CTGCCGTTTCG -> TGCCGTTTCGG
TGCCGTTTCGG -> GCCGTTTCGGA
GCCGTTTCGGA -> CCGTTTCGGAC
CCGTTTCGGAC -> CGTTTCGGACT
CGTTTCGGACT -> GTTTCGGACTG
GTTTCGGACTG -> TTTCGGACTGA
TTTCGGACTGA -> TTCGGACTGAT
TTCGGACTGAT -> TCGGACTGATG
TCGGACTGATG -> CGGACTGATGC
CGGACTGATGC -> GGACTGATGCC
GGACTGATGCC -> GACTGATGCCA
GACTGATGCCA -> ACTGATGCCAT
ACTGATGCCAT -> CTGATGCCATG
CTGATGCCATG -> TGATGCCATGA
TGATGCCATGA -> GATGCCATGAT
GATGCCATGAT -> ATGCCATGATA
ATGCCATGATA -> TGCCATGATAA
TGCCATGATAA -> GCCATGATAAG
GCCATGATAAG -> CCATGATAAGT
CCATGATAAGT -> CATGATAAGTA
CATGATAAGTA -> ATGATAAGTAT
ATGATAAGTAT -> TGATAAGTATT
TGATAAGTATT -> GATAAGTATTA
GATAAGTATTA -> ATAAGTATTAG
ATAAGTATTAG -> TAAGTATTAGC
TAAGTATTAGC -> AAGTATTAGCC
AAGTATTAGCC -> AGTATTAGCCC
AGTATTAGCCC -> GTATTAGCCCG
GTATTAGCCCG -> TATTAGCCCGT
TATTAGCCCGT -> ATTAGCCCGTC
ATTAGCCCGTC -> TTAGCCCGTCT
TTAGCCCGTCT -> TAGCCCGTCTT
TAGCCCGTCTT -> AGCCCGTCTTC
AGCCCGTCTTC -> GCCCGTCTTCT
GCCCGTCTTCT -> CCCGTCTTCTA
CCCGTCTTCTA -> CCGTCTTCTAA
CCGTCTTCTAA -> CGTCTTCTAAG
CGTCTTCTAAG -> GTCTTCTAAGG
GTCTTCTAAGG -> TCTTCTAAGGC
TCTTCTAAGGC -> CTTCTAAGGCG
CTTCTAAGGCG -> TTCTAAGGCGC
TTCTAAGGCGC -> TCTAAGGCGCG
TCTAAGGCGCG -> CTAAGGCGCGT
CTAAGGCGCGT -> TAAGGCGCGTG
TAAGGCGCGTG -> AAGGCGCGTGG
AAGGCGCGTGG -> AGGCGCGTGGT
AGGCGCGTGGT -> GGCGCGTGGTT
GGCGCGTGGTT -> GCGCGTGGTTA
GCGCGTGGTTA -> CGCGTGGTTAG
CGCGTGGTTAG -> GCGTGGTTAGA
GCGTGGTTAGA -> CGTGGTTAGAA
CGTGGTTAGAA -> GTGGTTAGAAC
GTGGTTAGAAC -> TGGTTAGAACC
TGGTTAGAACC -> GGTTAGAACCG
GGTTAGAACCG -> GTTAGAACCGT
GTTAGAACCGT -> TTAGAACCGTG
TTAGAACCGTG -> TAGAACCGTGA
TAGAACCGTGA -> AGAACCGTGAT
AGAACCGTGAT -> GAACCGTGATC
GAACCGTGATC -> AACCGTGATCT
AACCGTGATCT -> ACCGTGATCTA
ACCGTGATCTA -> CCGTGATCTAC
CCGTGATCTAC -> CGTGATCTACT
CGTGATCTACT -> GTGATCTACTT
GTGATCTACTT -> TGATCTACTTG
TGATCTACTTG -> GATCTACTTGT
GATCTACTTGT -> ATCTACTTGTC
ATCTACTTGTC -> TCTACTTGTCC
TCTACTTGTCC -> CTACTTGTCCT
CTACTTGTCCT -> TACTTGTCCTG
TACTTGTCCTG -> ACTTGTCCTGT
ACTTGTCCTGT -> CTTGTCCTGTC
CTTGTCCTGTC -> TTGTCCTGTCA
TTGTCCTGTCA -> TGTCCTGTCAG
TGTCCTGTCAG -> GTCCTGTCAGC
GTCCTGTCAGC -> TCCTGTCAGCT
TCCTGTCAGCT -> CCTGTCAGCTC
CCTGTCAGCTC -> CTGTCAGCTCT
CTGTCAGCTCT -> TGTCAGCTCTT
TGTCAGCTCTT -> GTCAGCTCTTG
GTCAGCTCTTG -> TCAGCTCTTGC
TCAGCTCTTGC -> CAGCTCTTGCG
CAGCTCTTGCG -> AGCTCTTGCGT
AGCTCTTGCGT -> GCTCTTGCGTC