GCCGCCTCCCAGGGCTTGA -> CCGCCTCCCAGGGCTTGAG
TGTTACGCCGTATACGTCG -> GTTACGCCGTATACGTCGA
CGGGCGCTTCGTGGAGAAC -> GGGCGCTTCGTGGAGAACC
TACCGGCCTGTCGAGACTC -> ACCGGCCTGTCGAGACTCT
AGATGGCCCGGTTACCACG -> GATGGCCCGGTTACCACGC
TCGCTACACGTTACTTGAT -> CGCTACACGTTACTTGATC
TATGCCGGCTGTTGTTGTT -> ATGCCGGCTGTTGTTGTTC
CCTGTCGAGACTCTTTGAA -> CTGTCGAGACTCTTTGAAA
TGCGGGAATGCTGGGTAAG -> GCGGGAATGCTGGGTAAGA
AGGGTAAAGAAAAGAAGGG -> GGGTAAAGAAAAGAAGGGT
GTCACCTTATTGATCTTCG -> TCACCTTATTGATCTTCGC
ATTTACTCTATAAAAGAAG -> TTTACTCTATAAAAGAAGT
TGTTTGTCCTTAAATACGA -> GTTTGTCCTTAAATACGAC
AGTCGATGCCGGCCTGTCG -> GTCGATGCCGGCCTGTCGA
AAGCCTGGACCGTAGCCAC -> AGCCTGGACCGTAGCCACA
CAGCTTTGTTCCTTGCGGG -> AGCTTTGTTCCTTGCGGGA
CGTCTGCAAGACATGACGA -> GTCTGCAAGACATGACGAC
GAGCGTAACAGGTCACCTT -> AGCGTAACAGGTCACCTTA
TACCAACTTAGTCCGGATC -> ACCAACTTAGTCCGGATCG
GGGCTTCTAGTCCGCGCAT -> GGCTTCTAGTCCGCGCATG
TTCGAGATCCCTTACATTG -> TCGAGATCCCTTACATTGT
AAAGCAATCCCTTGAACTG -> AAGCAATCCCTTGAACTGT
ATATCGTAAATTCGGCTCC -> TATCGTAAATTCGGCTCCT
CTGTCGAGACTCTGCCAGG -> TGTCGAGACTCTGCCAGGG
TGTATAGCTTCGAGTCGAT -> GTATAGCTTCGAGTCGATG
CGTGGACAGATCCAAGCAA -> GTGGACAGATCCAAGCAAT
TCGAGATGGCCCGGTTACC -> CGAGATGGCCCGGTTACCA
GCCCCGTCTGTATGCCGGC -> CCCCGTCTGTATGCCGGCT
TTGTTGCTTACCGGCCTGT -> TGTTGCTTACCGGCCTGTC
CACCCGGCCGCCAAGAAAT -> ACCCGGCCGCCAAGAAATC
TGGCCGTTTCCATGTGGGC -> GGCCGTTTCCATGTGGGCG
CTTGATCGGGGATCGGTCG -> TTGATCGGGGATCGGTCGA
AGGCCTGAGCTACACGACC -> GGCCTGAGCTACACGACCC
GCCCAGCTTTGTTCCTTGC -> CCCAGCTTTGTTCCTTGCG
TAAGAGGCACCCGGCCGCC -> AAGAGGCACCCGGCCGCCA
AATGACGTCACCGTCCATG -> ATGACGTCACCGTCCATGG
ATAAGTTTCGAGATCCCTT -> TAAGTTTCGAGATCCCTTA
GTCATTATCCGACATATCG -> TCATTATCCGACATATCGT
ACCGTCCATGGGCCTAGAG -> CCGTCCATGGGCCTAGAGT
AGCAGCCGTAGGGGGGGAT -> GCAGCCGTAGGGGGGGATA
ACGTCTACGCGACCATGCG -> CGTCTACGCGACCATGCGT
CCGGCCTGTCGAGACTCTT -> CGGCCTGTCGAGACTCTTT
GCGCAACAAGGGGTTTTGC -> CGCAACAAGGGGTTTTGCA
AAACGGATCGTACAAACCG -> AACGGATCGTACAAACCGT
CCTGTTACGCCGTATACGT -> CTGTTACGCCGTATACGTC
TGGGTAAGACGGTAGGATC -> GGGTAAGACGGTAGGATCA
ATGTATAGCTTCGAGTCGA -> TGTATAGCTTCGAGTCGAT
TTGTCCTTAAATACGACAT -> TGTCCTTAAATACGACATG
TCAGTCATTATCCGACATA -> CAGTCATTATCCGACATAT
TAATAGAGGTCGTCAGCTG -> AATAGAGGTCGTCAGCTGG
GCAGGGGTACTCGATTAAA -> CAGGGGTACTCGATTAAAG
AAAAAGCAATCCCTTGAAC -> AAAAGCAATCCCTTGAACT
TGCACAATATATGTTTGTC -> GCACAATATATGTTTGTCC
GAAAGGCACGCTGCAAACG -> AAAGGCACGCTGCAAACGC
GTTCGCCTGTACATGTGCA -> TTCGCCTGTACATGTGCAG
GTATACGTCGAGATGGCCC -> TATACGTCGAGATGGCCCG
TTTGCAAACAGGCGGATAG -> TTGCAAACAGGCGGATAGC
ACGTCGAGATGGCCCGGTT -> CGTCGAGATGGCCCGGTTA
TTGCTAGTTCTACATCCTG -> TGCTAGTTCTACATCCTGT
TGGGGCTTCTAGTCCGCGC -> GGGGCTTCTAGTCCGCGCA
TCCGTATCGTCTCCTCCTT -> CCGTATCGTCTCCTCCTTA
GAAGTGCCTTAGTAAGAGG -> AAGTGCCTTAGTAAGAGGC
AATACGACATGTAAAATGC -> ATACGACATGTAAAATGCT
TACACGTTACTTGATCGGG -> ACACGTTACTTGATCGGGG
TTAAAGGTCACTGAATGTT -> TAAAGGTCACTGAATGTTA
TCACTGAATGTTAAAAGTA -> CACTGAATGTTAAAAGTAC
ATGTGGGTAATTGAGTGAG -> TGTGGGTAATTGAGTGAGC
GTGAGCGCGGAGCCATGTG -> TGAGCGCGGAGCCATGTGA
ATCACAATTCCCAGCTGCC -> TCACAATTCCCAGCTGCCG
CCATGCCTACTAAGCCTGG -> CATGCCTACTAAGCCTGGA
CCCTGGGGCTTCTAGTCCG -> CCTGGGGCTTCTAGTCCGC
ACCCTAAGATAAGTTTCGA -> CCCTAAGATAAGTTTCGAG
AAAAGAAGGGTATTGCTTA -> AAAGAAGGGTATTGCTTAT
CTAGAAAAAAATACACGTC -> TAGAAAAAAATACACGTCT
TCGACGCCCTTGCTCCCGG -> CGACGCCCTTGCTCCCGGC
TTATATTGGTGATGTGCCA -> TATATTGGTGATGTGCCAG
GTATAAACCTTTGCAAACA -> TATAAACCTTTGCAAACAG
CGAAGATCTCGTATGTCGT -> GAAGATCTCGTATGTCGTG
GCACTTAGGATGAACTCTG -> CACTTAGGATGAACTCTGG
GTTCTTCACCATATCACAA -> TTCTTCACCATATCACAAC
CCGACATATCGTAAATTCG -> CGACATATCGTAAATTCGG
GGCTTCTAGTCCGCGCATG -> GCTTCTAGTCCGCGCATGA
TCAGCATGCTCAGCTAAAA -> CAGCATGCTCAGCTAAAAC
ACTTGATCGGGGATCGGTC -> CTTGATCGGGGATCGGTCG
TCGAGACTCTTTGAAATGT -> CGAGACTCTTTGAAATGTC
TAGTCCGGATCGTCTCTCA -> AGTCCGGATCGTCTCTCAG
ATAATGACAGGTCCGGCCT -> TAATGACAGGTCCGGCCTG
CAGCTTGAACTTTGCCGGG -> AGCTTGAACTTTGCCGGGA
ACAATATATGTTTGTCCTT -> CAATATATGTTTGTCCTTA
AGACTCGTGACACGGTGTA -> GACTCGTGACACGGTGTAC
CTACACGTTACTTGATCGG -> TACACGTTACTTGATCGGG
GCAATCCGCTGATGAAGTG -> CAATCCGCTGATGAAGTGC
ATTCGTCTGCAAGACATGA -> TTCGTCTGCAAGACATGAC
GTTAGCAGAATACTATGTG -> TTAGCAGAATACTATGTGG
AAATGGCTGGCTTCAGACC -> AATGGCTGGCTTCAGACCC
TGTTGTTCCCGAAAGTTAC -> GTTGTTCCCGAAAGTTACC
GCTCACCGTAGACTCGTGA -> CTCACCGTAGACTCGTGAC
GCACGATGCGGGAATGCTG -> CACGATGCGGGAATGCTGG
TTATGGTCCTTTAAATCTC -> TATGGTCCTTTAAATCTCA
CGAGACTCTCCACGACCGA -> GAGACTCTCCACGACCGAT
TTTCCTAGAAAAAAATACA -> TTCCTAGAAAAAAATACAC
GCAATACATTAGATGTGGG -> CAATACATTAGATGTGGGT
CCGGTTACCACGCACGATG -> CGGTTACCACGCACGATGC
TGTACAATGAGCCCCGGCC -> GTACAATGAGCCCCGGCCT
ACATGACGACTCATTACCA -> CATGACGACTCATTACCAA
CGGCTCCTATGCTAAGACT -> GGCTCCTATGCTAAGACTA
GGATCACAATTCCCAGCTG -> GATCACAATTCCCAGCTGC
TGAAATGTCGTTTTCCTAG -> GAAATGTCGTTTTCCTAGA
CTGGGTGAGGCGTGTTGGC -> TGGGTGAGGCGTGTTGGCT
CGTAGACTCGTGACACGGT -> GTAGACTCGTGACACGGTG
CGTCTCTCAGTCATTATCC -> GTCTCTCAGTCATTATCCG
AGACCATCATGCTAATGGC -> GACCATCATGCTAATGGCG
AGCGGGAAGTTCGCCTGTA -> GCGGGAAGTTCGCCTGTAC
ATGTGCAGTCGTCACGTCT -> TGTGCAGTCGTCACGTCTG
TGATTGTTGCTTACCGGCC -> GATTGTTGCTTACCGGCCT
CTAGTTCTACATCCTGTTA -> TAGTTCTACATCCTGTTAC
GCACGCTGCAAACGCTTTG -> CACGCTGCAAACGCTTTGA
TCAAGGCAGCTTGAACTTT -> CAAGGCAGCTTGAACTTTG
CCGTAGGGGGGGATATCGC -> CGTAGGGGGGGATATCGCT
GCTCTACAGTCAACTGCGC -> CTCTACAGTCAACTGCGCA
GCTTCCTATACCTGGTTAG -> CTTCCTATACCTGGTTAGC
CGCCCACTGCTAAATTCAG -> GCCCACTGCTAAATTCAGC
CATATTCGTATGGCCGGCT -> ATATTCGTATGGCCGGCTG
AGGTCGTCAGCTGGTGTCA -> GGTCGTCAGCTGGTGTCAA
CTCTTTGAAATGTCGTTTT -> TCTTTGAAATGTCGTTTTC
GCTACACGACCCCTGGGGC -> CTACACGACCCCTGGGGCT
AGACTAATTAAACGCCAAT -> GACTAATTAAACGCCAATT
AGGATGTCATATTCGTATG -> GGATGTCATATTCGTATGG
CCGCTGATGAAGTGCCTTA -> CGCTGATGAAGTGCCTTAG
TATAGCTTCGAGTCGATGC -> ATAGCTTCGAGTCGATGCC
TCATATTCGTATGGCCGGC -> CATATTCGTATGGCCGGCT
CTTTGAAATGTCGTTTTCC -> TTTGAAATGTCGTTTTCCT
TTATCACAAAAATTCGAGC -> TATCACAAAAATTCGAGCA
TTCGCGGGTTATGGTCCTT -> TCGCGGGTTATGGTCCTTT
GTTTTCCTAGAAAAAAATA -> TTTTCCTAGAAAAAAATAC,TTTTCCTAGAAAAAAATAC
AGTCATTATCCGACATATC -> GTCATTATCCGACATATCG
TGATCGGGGATCGGTCGAC -> GATCGGGGATCGGTCGACG
CGAAATTCATGACCCCCCC -> GAAATTCATGACCCCCCCT
TGGGTAATTGAGTGAGCGT -> GGGTAATTGAGTGAGCGTA
CTGAGCTACACGACCCCTG -> TGAGCTACACGACCCCTGG
GGCTTGAGATTATATTGGT -> GCTTGAGATTATATTGGTG
CTCGTGACACGGTGTACAA -> TCGTGACACGGTGTACAAT
GTGTCAAGGCAGCTTGAAC -> TGTCAAGGCAGCTTGAACT
GAGCCCTTATCGAGTGGCT -> AGCCCTTATCGAGTGGCTC
CCGTATCGTCTCCTCCTTA -> CGTATCGTCTCCTCCTTAT
GTGGACAGATCCAAGCAAT -> TGGACAGATCCAAGCAATA
ACAGTCCGAAATTCATGAC -> CAGTCCGAAATTCATGACC
AGCAGAACCCAAATGTGAG -> GCAGAACCCAAATGTGAGC
CGGTGTACAATGAGCCCCG -> GGTGTACAATGAGCCCCGG
CTTTGATCCGCGATTCGTC -> TTTGATCCGCGATTCGTCT
CTGCTAAATTCAGCAGCCG -> TGCTAAATTCAGCAGCCGT
TCTCAGTCATTATCCGACA -> CTCAGTCATTATCCGACAT
CGGATCGTACAAACCGTAT -> GGATCGTACAAACCGTATG
ATTCCGTATCGTCTCCTCC -> TTCCGTATCGTCTCCTCCT
GAGCACCCGACTCTCGCGC -> AGCACCCGACTCTCGCGCT
TCACCGTAGACTCGTGACA -> CACCGTAGACTCGTGACAC
TTAAATACGACATGTAAAA -> TAAATACGACATGTAAAAT
GAAGTTCGCCTGTACATGT -> AAGTTCGCCTGTACATGTG
CCCGGCCGCCAAGAAATCT -> CCGGCCGCCAAGAAATCTG
GGGGCTTCTAGTCCGCGCA -> GGGCTTCTAGTCCGCGCAT
TCCTCCTTATATCTTGTAG -> CCTCCTTATATCTTGTAGC
AACCTTTGCAAACAGGCGG -> ACCTTTGCAAACAGGCGGA
TGTCGAGACTCTCCACGAC -> GTCGAGACTCTCCACGACC
ATTGTTGCTTACCGGCCTG -> TTGTTGCTTACCGGCCTGT
CAGTCATTATCCGACATAT -> AGTCATTATCCGACATATC
AATGCTGGTTTCAATTGCT -> ATGCTGGTTTCAATTGCTA
GTAGCGGGAAGTTCGCCTG -> TAGCGGGAAGTTCGCCTGT
TCGTTTTCCTAGAAAAAAA -> CGTTTTCCTAGAAAAAAAT,CGTTTTCCTAGAAAAAAAT
GCTAAGACTAATAAGCAAT -> CTAAGACTAATAAGCAATC
GGGGGATATCGCTACACGT -> GGGGATATCGCTACACGTT
CCCGAAAGTTACCCTAAGA -> CCGAAAGTTACCCTAAGAT
CCGACGCCCCGTCTGTATG -> CGACGCCCCGTCTGTATGC
GCCACCAAAATGGCTGGCT -> CCACCAAAATGGCTGGCTT
ACGCACGATGCGGGAATGC -> CGCACGATGCGGGAATGCT
TCAACTGCGCAACAAGGGG -> CAACTGCGCAACAAGGGGT
ATACACGTCTACGCGACCA -> TACACGTCTACGCGACCAT
CCCTTATCGAGTGGCTCAC -> CCTTATCGAGTGGCTCACC
AAATCTAGAGAACTTTCGA -> AATCTAGAGAACTTTCGAG
GTGAGGCGTGTTGGCTCTT -> TGAGGCGTGTTGGCTCTTG
ACTCTTTGAAATGTCGTTT -> CTCTTTGAAATGTCGTTTT
AAAATACCCAGAAATAATG -> AAATACCCAGAAATAATGA
AGTGCAGGGTAAAGAAAAG -> GTGCAGGGTAAAGAAAAGA
AATTGAGTGAGCGTAACAG -> ATTGAGTGAGCGTAACAGG
CTGCCGGAATTTACTCTAT -> TGCCGGAATTTACTCTATA
GGCCTGTCGAGACTCTCCA -> GCCTGTCGAGACTCTCCAC
GCTTTGTTCCTTGCGGGAA -> CTTTGTTCCTTGCGGGAAA
GCCCTTATCGAGTGGCTCA -> CCCTTATCGAGTGGCTCAC
TCTTCACCATATCACAACG -> CTTCACCATATCACAACGG
TACGGTTTAAAGCCCAGCT -> ACGGTTTAAAGCCCAGCTT
GTGTACTTATGGTAGCGGG -> TGTACTTATGGTAGCGGGA
ATCCTGTTACGCCGTATAC -> TCCTGTTACGCCGTATACG
GGGTGAGGCGTGTTGGCTC -> GGTGAGGCGTGTTGGCTCT
TTTTCCTAGAAAAAAATAC -> TTTCCTAGAAAAAAATACG,TTTCCTAGAAAAAAATACA,TTTCCTAGAAAAAAATACG,TTTCCTAGAAAAAAATACC
GCGTGTTGGCTCTTGATTA -> CGTGTTGGCTCTTGATTAG
TAAAACGGATCGTACAAAC -> AAAACGGATCGTACAAACC
CGAGCAGAACCCAAATGTG -> GAGCAGAACCCAAATGTGA
ATATCACAACGGCGCACTT -> TATCACAACGGCGCACTTA
GATCTCGTATGTCGTGTCC -> ATCTCGTATGTCGTGTCCA
ACATGGTTCGTTTTCCTAG -> CATGGTTCGTTTTCCTAGA
CTTGTAGCCACGCTTCCTA -> TTGTAGCCACGCTTCCTAT
ACAAGCCACTCAATAATGA -> CAAGCCACTCAATAATGAA
GGCTCCTATGCTAAGACTA -> GCTCCTATGCTAAGACTAA
TTGGTTGCCGATTCCGTAT -> TGGTTGCCGATTCCGTATC
TCTTTGAAATGTCGTTTTC -> CTTTGAAATGTCGTTTTCC
ACTCATTACCAACTTAGTC -> CTCATTACCAACTTAGTCC
GTAAGACGGTAGGATCACA -> TAAGACGGTAGGATCACAA
CGCTCTACAGTCAACTGCG -> GCTCTACAGTCAACTGCGC
CGTCGACAAACAAGCCACT -> GTCGACAAACAAGCCACTC
ATGCGTTTCAACCGCGCTG -> TGCGTTTCAACCGCGCTGC
GGGTTTTGCACAATATATG -> GGTTTTGCACAATATATGT
GTATTGCTTATGCGAGGTA -> TATTGCTTATGCGAGGTAT
GACTAATTAAACGCCAATT -> ACTAATTAAACGCCAATTT
CTGCCTCCTACCGTGTTTC -> TGCCTCCTACCGTGTTTCA
TTATGGTAGCGGGAAGTTC -> TATGGTAGCGGGAAGTTCG
ACTATAGCATCACAATAGC -> CTATAGCATCACAATAGCG
CATGTGACACAGGGCGTCT -> ATGTGACACAGGGCGTCTT
ACCCAGAAATAATGACAGG -> CCCAGAAATAATGACAGGT
CCCTTATCACAAAAATTCG -> CCTTATCACAAAAATTCGA
GCGCACTTAGGATGAACTC -> CGCACTTAGGATGAACTCT
CCAATTTGTCAGGCCTGAG -> CAATTTGTCAGGCCTGAGC
CCCCTCAAACATATTGCTG -> CCCTCAAACATATTGCTGA
AATCTAAAAAGCAATCCCT -> ATCTAAAAAGCAATCCCTT
AATTTACTCTATAAAAGAA -> ATTTACTCTATAAAAGAAG
AAGTTACCCTAAGATAAGT -> AGTTACCCTAAGATAAGTT
GGGGATATCGCTACACGTT -> GGGATATCGCTACACGTTA
CACAACGGCGCACTTAGGA -> ACAACGGCGCACTTAGGAT
CACCTCCAGGATGTCATAT -> ACCTCCAGGATGTCATATT
ACGGTGTACAATGAGCCCC -> CGGTGTACAATGAGCCCCG
TATCACAACGGCGCACTTA -> ATCACAACGGCGCACTTAG
AAACATATTGCTGAGGCCG -> AACATATTGCTGAGGCCGA
GATTAAAGGTCACTGAATG -> ATTAAAGGTCACTGAATGT
CGTTTCAACCGCGCTGCAG -> GTTTCAACCGCGCTGCAGG
TAGTCGGACTATAGCATCA -> AGTCGGACTATAGCATCAC
TACGAAAGGCACGCTGCAA -> ACGAAAGGCACGCTGCAAA
TATTGGTGATGTGCCAGGC -> ATTGGTGATGTGCCAGGCT
GGAGAACCTCCGTATCAAG -> GAGAACCTCCGTATCAAGT
GCCAGGGAAGTTTTTCCTA -> CCAGGGAAGTTTTTCCTAG
TCGAGTAATAGAGGTCGTC -> CGAGTAATAGAGGTCGTCA
TGCTAATAATAATAAGCCA -> GCTAATAATAATAAGCCAT
GCAGGGTAAAGAAAAGAAG -> CAGGGTAAAGAAAAGAAGG
CGGATCGTCTCTCAGTCAT -> GGATCGTCTCTCAGTCATT
TTGATTAGGCTGAACCCAC -> TGATTAGGCTGAACCCACC
GATCTTCGCCCACTGCTAA -> ATCTTCGCCCACTGCTAAA
GCGCTGATTGTTGCTTACC -> CGCTGATTGTTGCTTACCG
GCTCCCGGCCATACGGCTC -> CTCCCGGCCATACGGCTCC
CGACAAACAAGCCACTCAA -> GACAAACAAGCCACTCAAT
GCGGGAATGCTGGGTAAGA -> CGGGAATGCTGGGTAAGAC
CGCGACCATGCGTTTCAAC -> GCGACCATGCGTTTCAACC
GGCAGCTTGAACTTTGCCG -> GCAGCTTGAACTTTGCCGG
GAGTAATAGAGGTCGTCAG -> AGTAATAGAGGTCGTCAGC
GGGTCAAACCCAGTAATCT -> GGTCAAACCCAGTAATCTA
TCCCAGGGCTTGAGATTAT -> CCCAGGGCTTGAGATTATA
AGAGGCACCCGGCCGCCAA -> GAGGCACCCGGCCGCCAAG
TTCTAGTCCGCGCATGATG -> TCTAGTCCGCGCATGATGG
TCCCGAAAGTTACCCTAAG -> CCCGAAAGTTACCCTAAGA
CGAGTGGCTCACCGTAGAC -> GAGTGGCTCACCGTAGACT
GTTTAAAGCCCAGCTTTGT -> TTTAAAGCCCAGCTTTGTT
TTCGGCTCCTATGCTAAGA -> TCGGCTCCTATGCTAAGAC
CTCTACAGTCAACTGCGCA -> TCTACAGTCAACTGCGCAA
CAAGGCAGCTTGAACTTTG -> AAGGCAGCTTGAACTTTGC
AAATACACGTCTACGCGAC -> AATACACGTCTACGCGACC
CCTCCTACCGTGTTTCATG -> CTCCTACCGTGTTTCATGA
GAGACTCTGCCAGGGAAGT -> AGACTCTGCCAGGGAAGTT
TTGCTGAGGCCGAATAGCG -> TGCTGAGGCCGAATAGCGA
TTCACCATATCACAACGGC -> TCACCATATCACAACGGCG
GACGGGCAGAGAAGCTTTG -> ACGGGCAGAGAAGCTTTGC
ACCGTATGTATAGCTTCGA -> CCGTATGTATAGCTTCGAG
AAATACCCAGAAATAATGA -> AATACCCAGAAATAATGAC
TGTATACAGTTGGTTGCCG -> GTATACAGTTGGTTGCCGA
AACCGCGCTGCAGGCAGGG -> ACCGCGCTGCAGGCAGGGG
AAAGTACGCTAAAACCAGA -> AAGTACGCTAAAACCAGAT
CCCTTGCTCCCGGCCATAC -> CCTTGCTCCCGGCCATACG
GCTCTTGATTAGGCTGAAC -> CTCTTGATTAGGCTGAACC
CATGCTAATAATAATAAGC -> ATGCTAATAATAATAAGCC
AGCAATACATTAGATGTGG -> GCAATACATTAGATGTGGG
TCTAGTCCGCGCATGATGG -> CTAGTCCGCGCATGATGGG
CCACCAAAATGGCTGGCTT -> CACCAAAATGGCTGGCTTC
GGATCGTCTCTCAGTCATT -> GATCGTCTCTCAGTCATTA
AGGCTGAACCCACCTCCAG -> GGCTGAACCCACCTCCAGG
AGACTCTTTGAAATGTCGT -> GACTCTTTGAAATGTCGTT
GCAAACGCTTTGATCCGCG -> CAAACGCTTTGATCCGCGA
TTACCCTAAGATAAGTTTC -> TACCCTAAGATAAGTTTCG
ACTGCTAAATTCAGCAGCC -> CTGCTAAATTCAGCAGCCG
CCTTATCGAGTGGCTCACC -> CTTATCGAGTGGCTCACCG
CGTAAATTCGGCTCCTATG -> GTAAATTCGGCTCCTATGC
ACGACATGTAAAATGCTGG -> CGACATGTAAAATGCTGGT
TGTAAAATGCTGGTTTCAA -> GTAAAATGCTGGTTTCAAT
ACAAGGGGTTTTGCACAAT -> CAAGGGGTTTTGCACAATA
CCCCCTCGGGCGCTTCGTG -> CCCCTCGGGCGCTTCGTGG
CGGAGCCATGTGACACAGG -> GGAGCCATGTGACACAGGG
ACGCCAATTTGTCAGGCCT -> CGCCAATTTGTCAGGCCTG
GCCGTAGGGGGGGATATCG -> CCGTAGGGGGGGATATCGC
AAATTCATGACCCCCCCTC -> AATTCATGACCCCCCCTCG
AAAATACGAAAGGCACGCT -> AAATACGAAAGGCACGCTG
GCTGATTGTTGCTTACCGG -> CTGATTGTTGCTTACCGGC
CTTACAGACTAATTAAACG -> TTACAGACTAATTAAACGC
CTAGAGAACTTTCGAGTAA -> TAGAGAACTTTCGAGTAAT
GGGTAAGACGGTAGGATCA -> GGTAAGACGGTAGGATCAC
ACAATAGCGCTGATTGTTG -> CAATAGCGCTGATTGTTGC
CACGTTACTTGATCGGGGA -> ACGTTACTTGATCGGGGAT
GTCGAGATGGCCCGGTTAC -> TCGAGATGGCCCGGTTACC
TAGTCCGCGCATGATGGGA -> AGTCCGCGCATGATGGGAG
TCCGACGGGCAGAGAAGCT -> CCGACGGGCAGAGAAGCTT
TAAGCCTGGACCGTAGCCA -> AAGCCTGGACCGTAGCCAC
TCCGGATCGTCTCTCAGTC -> CCGGATCGTCTCTCAGTCA
GGAAGTTTTTCCTAGAAAA -> GAAGTTTTTCCTAGAAAAA
TGCGTGGACAGATCCAAGC -> GCGTGGACAGATCCAAGCA
TGGCTCACCGTAGACTCGT -> GGCTCACCGTAGACTCGTG
AGGTCACTGAATGTTAAAA -> GGTCACTGAATGTTAAAAG
CCAAGAAATCTGCCTCCTA -> CAAGAAATCTGCCTCCTAC
TGCAAGACATGACGACTCA -> GCAAGACATGACGACTCAT
AAGAAATCTGCCTCCTACC -> AGAAATCTGCCTCCTACCG
AATATATGTTTGTCCTTAA -> ATATATGTTTGTCCTTAAA
GAAATATAATTAGGGGTCA -> AAATATAATTAGGGGTCAA
CAAGACATGACGACTCATT -> AAGACATGACGACTCATTA
TCAAACCCAGTAATCTAAA -> CAAACCCAGTAATCTAAAA
TTAGGGGTCAAACCCAGTA -> TAGGGGTCAAACCCAGTAA
GTGTCCATGCTAATAATAA -> TGTCCATGCTAATAATAAT
AAGACTAATAAGCAATCCG -> AGACTAATAAGCAATCCGC
ATCCGACATATCGTAAATT -> TCCGACATATCGTAAATTC
CTTGAACTTTGCCGGGAGC -> TTGAACTTTGCCGGGAGCC
GCTTTGCCGACGCCCCGTC -> CTTTGCCGACGCCCCGTCT
CCAGGGCTTGAGATTATAT -> CAGGGCTTGAGATTATATT
AGAGAAGCTTTGCCGACGC -> GAGAAGCTTTGCCGACGCC
GAATACTATGTGGGCCGCC -> AATACTATGTGGGCCGCCT
ATACGAAAGGCACGCTGCA -> TACGAAAGGCACGCTGCAA
GAGGCCGAATAGCGACCTG -> AGGCCGAATAGCGACCTGT
ATTATATTGGTGATGTGCC -> TTATATTGGTGATGTGCCA
TGAGCCCCGGCCTGTCGAG -> GAGCCCCGGCCTGTCGAGA
AAAGGCACGCTGCAAACGC -> AAGGCACGCTGCAAACGCT
TAAACGCCAATTTGTCAGG -> AAACGCCAATTTGTCAGGC
ATCCGTACTCTTACAGACT -> TCCGTACTCTTACAGACTA
CCCAAATGTGAGCGCGGAG -> CCAAATGTGAGCGCGGAGC
GTCCATGCTAATAATAATA -> TCCATGCTAATAATAATAA
TTCCCGAAAGTTACCCTAA -> TCCCGAAAGTTACCCTAAG
CCGTAGCCACACCGATCCG -> CGTAGCCACACCGATCCGT
TTGCTTATGCGAGGTATAA -> TGCTTATGCGAGGTATAAA
CTTTGTTCCTTGCGGGAAA -> TTTGTTCCTTGCGGGAAAA
CGCCCCGTCTGTATGCCGG -> GCCCCGTCTGTATGCCGGC
CTTGATTAGGCTGAACCCA -> TTGATTAGGCTGAACCCAC
CGTGACACGGTGTACAATG -> GTGACACGGTGTACAATGA
AGTACGCTAAAACCAGATT -> GTACGCTAAAACCAGATTC
TGTCGAGACTCTGCCAGGG -> GTCGAGACTCTGCCAGGGA
CTTGCGGGAAAATCTAGAG -> TTGCGGGAAAATCTAGAGA
CGCCAATTTGTCAGGCCTG -> GCCAATTTGTCAGGCCTGA
ACTTTCGAGTAATAGAGGT -> CTTTCGAGTAATAGAGGTC
ACACGACCCCTGGGGCTTC -> CACGACCCCTGGGGCTTCT
CGCCCTTGCTCCCGGCCAT -> GCCCTTGCTCCCGGCCATA
AGCTTTGTTCCTTGCGGGA -> GCTTTGTTCCTTGCGGGAA
CCTAGAAAAAAATACCCAG -> CTAGAAAAAAATACCCAGA
AACTTTCGAGTAATAGAGG -> ACTTTCGAGTAATAGAGGT
TCGAGTCGATGCCGGCCTG -> CGAGTCGATGCCGGCCTGT
TGCCTCCTACCGTGTTTCA -> GCCTCCTACCGTGTTTCAT
TCGGGCGCTTCGTGGAGAA -> CGGGCGCTTCGTGGAGAAC
CATCATGCTAATGGCGACA -> ATCATGCTAATGGCGACAC
GAAGGGTATTGCTTATGCG -> AAGGGTATTGCTTATGCGA
TGATCTTCGCCCACTGCTA -> GATCTTCGCCCACTGCTAA
TATATGTTTGTCCTTAAAT -> ATATGTTTGTCCTTAAATA
CAGACCCCTCAAACATATT -> AGACCCCTCAAACATATTG
CGCTGATGAAGTGCCTTAG -> GCTGATGAAGTGCCTTAGT
GATATCGCTACACGTTACT -> ATATCGCTACACGTTACTT
CATGGTTCGTTTTCCTAGA -> ATGGTTCGTTTTCCTAGAA
GTCACGTCTGCTAAAGGGC -> TCACGTCTGCTAAAGGGCC
CGCGCTGCAGGCAGGGGTA -> GCGCTGCAGGCAGGGGTAC
AAAACCAGATTCGACAGTC -> AAACCAGATTCGACAGTCC
AGCACCCGACTCTCGCGCT -> GCACCCGACTCTCGCGCTC
TGTCGTTTTCCTAGAAAAA -> GTCGTTTTCCTAGAAAAAA
GTAAGGCCTTCGCGGGTTA -> TAAGGCCTTCGCGGGTTAT
GTCTACGCGACCATGCGTT -> TCTACGCGACCATGCGTTT
CGTGTTGGCTCTTGATTAG -> GTGTTGGCTCTTGATTAGG
CAATTTGTCAGGCCTGAGC -> AATTTGTCAGGCCTGAGCT
CGACCTGTATACAGTTGGT -> GACCTGTATACAGTTGGTT
AGAAAAAAATACGAAAGGC -> GAAAAAAATACGAAAGGCA
AATGTGAGCGCGGAGCCAT -> ATGTGAGCGCGGAGCCATG
TGTCCATGCTAATAATAAT -> GTCCATGCTAATAATAATA
TCCATGCTAATAATAATAA -> CCATGCTAATAATAATAAG
TGGACCGTAGCCACACCGA -> GGACCGTAGCCACACCGAT
ATCACAACGGCGCACTTAG -> TCACAACGGCGCACTTAGG
TGCTAAATTCAGCAGCCGT -> GCTAAATTCAGCAGCCGTA
AGTTCGCCTGTACATGTGC -> GTTCGCCTGTACATGTGCA
TTACCACGCACGATGCGGG -> TACCACGCACGATGCGGGA
GCGTAACAGGTCACCTTAT -> CGTAACAGGTCACCTTATT
CCGGCCTGTCGAGACTCTG -> CGGCCTGTCGAGACTCTGC
TCACCATATCACAACGGCG -> CACCATATCACAACGGCGC
CTCCTACCGTGTTTCATGA -> TCCTACCGTGTTTCATGAA
CAGAGAAGCTTTGCCGACG -> AGAGAAGCTTTGCCGACGC
AAATACGACATGTAAAATG -> AATACGACATGTAAAATGC
TGCAAACGCTTTGATCCGC -> GCAAACGCTTTGATCCGCG
GCACCCGGCCGCCAAGAAA -> CACCCGGCCGCCAAGAAAT
CCACGCACGATGCGGGAAT -> CACGCACGATGCGGGAATG
ACACCCTACTAGTCGGACT -> CACCCTACTAGTCGGACTA
AAACAAGCCACTCAATAAT -> AACAAGCCACTCAATAATG
ACTCTAACATGGTTCGTTT -> CTCTAACATGGTTCGTTTT
GGTTTAAAGCCCAGCTTTG -> GTTTAAAGCCCAGCTTTGT
ACATTGTTCAAATGACGTC -> CATTGTTCAAATGACGTCA
AGCATCACAATAGCGCTGA -> GCATCACAATAGCGCTGAT
CCCCCCTCGGGCGCTTCGT -> CCCCCTCGGGCGCTTCGTG
AAGCAATCCCTTGAACTGT -> AGCAATCCCTTGAACTGTA
GTATGCCGGCTGTTGTTGT -> TATGCCGGCTGTTGTTGTT
GTAATAGAGGTCGTCAGCT -> TAATAGAGGTCGTCAGCTG
CTAATAAGCAATCCGCTGA -> TAATAAGCAATCCGCTGAT
GTAATTGAGTGAGCGTAAC -> TAATTGAGTGAGCGTAACA
TCTCTCAGTCATTATCCGA -> CTCTCAGTCATTATCCGAC
GTTTGTCCTTAAATACGAC -> TTTGTCCTTAAATACGACA
GTTTCAATTGCTAGTTCTA -> TTTCAATTGCTAGTTCTAC
CCGGCTGTTGTTGTTCCCG -> CGGCTGTTGTTGTTCCCGA
TTTGCACAATATATGTTTG -> TTGCACAATATATGTTTGT
AATTCGGCTCCTATGCTAA -> ATTCGGCTCCTATGCTAAG
TAAATCTCAGACCCCTCAA -> AAATCTCAGACCCCTCAAA
GCTAATGGCGACACCCTAC -> CTAATGGCGACACCCTACT
CTGGTTTCAATTGCTAGTT -> TGGTTTCAATTGCTAGTTC
GCCTTAGTAAGAGGCACCC -> CCTTAGTAAGAGGCACCCG
TATAAACCTTTGCAAACAG -> ATAAACCTTTGCAAACAGG
TCGTCTCTCAGTCATTATC -> CGTCTCTCAGTCATTATCC
ATGCCGGCCTGTCGAGACT -> TGCCGGCCTGTCGAGACTC
AAACCTTTGCAAACAGGCG -> AACCTTTGCAAACAGGCGG
CACTGAATGTTAAAAGTAC -> ACTGAATGTTAAAAGTACG
GTCCGAAATTCATGACCCC -> TCCGAAATTCATGACCCCC
GTTCCCGAAAGTTACCCTA -> TTCCCGAAAGTTACCCTAA
TACTTATGGTAGCGGGAAG -> ACTTATGGTAGCGGGAAGT
TCGTCTCCTCCTTATATCT -> CGTCTCCTCCTTATATCTT
TGGCTTCAGACCCTTATCA -> GGCTTCAGACCCTTATCAC
TACGCTAAAACCAGATTCG -> ACGCTAAAACCAGATTCGA
TTCCTAGAAAAAAATACGA -> TCCTAGAAAAAAATACGAA
AAAATGCTGGTTTCAATTG -> AAATGCTGGTTTCAATTGC
GGCCTGTCGAGACTCTTTG -> GCCTGTCGAGACTCTTTGA
TACGTCGAGATGGCCCGGT -> ACGTCGAGATGGCCCGGTT
AATATAATTAGGGGTCAAA -> ATATAATTAGGGGTCAAAC
GCTTGAACTTTGCCGGGAG -> CTTGAACTTTGCCGGGAGC
TGATTAGGCTGAACCCACC -> GATTAGGCTGAACCCACCT
CGTACAAACCGTATGTATA -> GTACAAACCGTATGTATAG
GCTAAAACCAGATTCGACA -> CTAAAACCAGATTCGACAG
TGTCGTGTCCATGCTAATA -> GTCGTGTCCATGCTAATAA
CTAATGGCGACACCCTACT -> TAATGGCGACACCCTACTA
CCTATGCTAAGACTAATAA -> CTATGCTAAGACTAATAAG
GCTAAAACGGATCGTACAA -> CTAAAACGGATCGTACAAA
ATTGATCTTCGCCCACTGC -> TTGATCTTCGCCCACTGCT
CATGAATCAACAAATCAGC -> ATGAATCAACAAATCAGCA
CGGGAAGTTCGCCTGTACA -> GGGAAGTTCGCCTGTACAT
ATCACAATAGCGCTGATTG -> TCACAATAGCGCTGATTGT
CCTTATCACAAAAATTCGA -> CTTATCACAAAAATTCGAG
CATGTGGGCGAAGATCTCG -> ATGTGGGCGAAGATCTCGT
ATCGTACAAACCGTATGTA -> TCGTACAAACCGTATGTAT
TTTCATGAATCAACAAATC -> TTCATGAATCAACAAATCA
GCCGGCTGTGCGTGGACAG -> CCGGCTGTGCGTGGACAGA
TGCCGGCCTGTCGAGACTC -> GCCGGCCTGTCGAGACTCT
TCCTAGAAAAAAATACGGT -> CCTAGAAAAAAATACGGTT
CCGGGAGCCCCCGTCGACA -> CGGGAGCCCCCGTCGACAA
GGCTTCAGACCCTTATCAC -> GCTTCAGACCCTTATCACA
CCTGGACCGTAGCCACACC -> CTGGACCGTAGCCACACCG
CAACTTAGTCCGGATCGTC -> AACTTAGTCCGGATCGTCT
AAAGTTACCCTAAGATAAG -> AAGTTACCCTAAGATAAGT
GGGGATCGGTCGACGCCCT -> GGGATCGGTCGACGCCCTT
ACCAAAATGGCTGGCTTCA -> CCAAAATGGCTGGCTTCAG
TCGTAAATTCGGCTCCTAT -> CGTAAATTCGGCTCCTATG
AATACGAAAGGCACGCTGC -> ATACGAAAGGCACGCTGCA
TGTCGAGACTCTAACATGG -> GTCGAGACTCTAACATGGT
GCTGGCTTCAGACCCTTAT -> CTGGCTTCAGACCCTTATC
GAGGCACCCGGCCGCCAAG -> AGGCACCCGGCCGCCAAGA
AATCCGCTGATGAAGTGCC -> ATCCGCTGATGAAGTGCCT
TCTTGTAGCCACGCTTCCT -> CTTGTAGCCACGCTTCCTA
TCGTATGTCGTGTCCATGC -> CGTATGTCGTGTCCATGCT
ACACCGATCCGTACTCTTA -> CACCGATCCGTACTCTTAC
CTGGTGTCAAGGCAGCTTG -> TGGTGTCAAGGCAGCTTGA
AAGGCACGCTGCAAACGCT -> AGGCACGCTGCAAACGCTT
CCGTTTCCATGTGGGCGAA -> CGTTTCCATGTGGGCGAAG
CTCAGCTAAAACGGATCGT -> TCAGCTAAAACGGATCGTA
TAAGCAATCCGCTGATGAA -> AAGCAATCCGCTGATGAAG
AGAAGTGCAGGGTAAAGAA -> GAAGTGCAGGGTAAAGAAA
GGATGAACTCTGGGTGAGG -> GATGAACTCTGGGTGAGGC
GCGGGAAAATCTAGAGAAC -> CGGGAAAATCTAGAGAACT
GGCGTGTTGGCTCTTGATT -> GCGTGTTGGCTCTTGATTA
CGGAATTTACTCTATAAAA -> GGAATTTACTCTATAAAAG
ATCAACAAATCAGCATGCT -> TCAACAAATCAGCATGCTC
ATAATAAGCCATAGCGGGA -> TAATAAGCCATAGCGGGAT
CTTCCTATACCTGGTTAGC -> TTCCTATACCTGGTTAGCA
AGCGCGGAGCCATGTGACA -> GCGCGGAGCCATGTGACAC
ACGGGCAGAGAAGCTTTGC -> CGGGCAGAGAAGCTTTGCC
GGGATCGGTCGACGCCCTT -> GGATCGGTCGACGCCCTTG
TGTGAGCGCGGAGCCATGT -> GTGAGCGCGGAGCCATGTG
GCTTATGCGAGGTATAAAC -> CTTATGCGAGGTATAAACC
GATGCGGGAATGCTGGGTA -> ATGCGGGAATGCTGGGTAA
GTTGCCGATTCCGTATCGT -> TTGCCGATTCCGTATCGTC
TAAATACGACATGTAAAAT -> AAATACGACATGTAAAATG
AAGACGGTAGGATCACAAT -> AGACGGTAGGATCACAATT
AAACGCCAATTTGTCAGGC -> AACGCCAATTTGTCAGGCC
TAGGGGTCAAACCCAGTAA -> AGGGGTCAAACCCAGTAAT
CAGCCGTAGGGGGGGATAT -> AGCCGTAGGGGGGGATATC
AACTTAGTCCGGATCGTCT -> ACTTAGTCCGGATCGTCTC
GTTCTACATCCTGTTACGC -> TTCTACATCCTGTTACGCC
TAGCCACACCGATCCGTAC -> AGCCACACCGATCCGTACT
CCCGTCGACAAACAAGCCA -> CCGTCGACAAACAAGCCAC
CTCCGACGGGCAGAGAAGC -> TCCGACGGGCAGAGAAGCT
ACCAACTTAGTCCGGATCG -> CCAACTTAGTCCGGATCGT
CACGGTGTACAATGAGCCC -> ACGGTGTACAATGAGCCCC
TTAGGCTGAACCCACCTCC -> TAGGCTGAACCCACCTCCA
GCAGCCGTAGGGGGGGATA -> CAGCCGTAGGGGGGGATAT
CTGTAAGGCCTTCGCGGGT -> TGTAAGGCCTTCGCGGGTT
TTCCATGTGGGCGAAGATC -> TCCATGTGGGCGAAGATCT
ACCTCCAGGATGTCATATT -> CCTCCAGGATGTCATATTC
CATGACGACTCATTACCAA -> ATGACGACTCATTACCAAC
GCTTCAGACCCTTATCACA -> CTTCAGACCCTTATCACAA
GTACTCGATTAAAGGTCAC -> TACTCGATTAAAGGTCACT
AACTGCGCAACAAGGGGTT -> ACTGCGCAACAAGGGGTTT
TAATAATAAGCCATAGCGG -> AATAATAAGCCATAGCGGG
TCAATAATGAAGACCATCA -> CAATAATGAAGACCATCAT
CTAGAAAAAAATACCCAGA -> TAGAAAAAAATACCCAGAA
GGTTCGTTTTCCTAGAAAA -> GTTCGTTTTCCTAGAAAAA
TGTTCTTCACCATATCACA -> GTTCTTCACCATATCACAA
ACGACTCATTACCAACTTA -> CGACTCATTACCAACTTAG
TCCGTATCAAGTGTACTTA -> CCGTATCAAGTGTACTTAT
GCGCGGAGCCATGTGACAC -> CGCGGAGCCATGTGACACA
AGAACCCAAATGTGAGCGC -> GAACCCAAATGTGAGCGCG
ATAGCGACCTGTATACAGT -> TAGCGACCTGTATACAGTT
GGCTGAACCCACCTCCAGG -> GCTGAACCCACCTCCAGGA
GAACTTTGCCGGGAGCCCC -> AACTTTGCCGGGAGCCCCC
ATTGAGTGAGCGTAACAGG -> TTGAGTGAGCGTAACAGGT
GTTTCAACCGCGCTGCAGG -> TTTCAACCGCGCTGCAGGC
GTCAAGGCAGCTTGAACTT -> TCAAGGCAGCTTGAACTTT
CGCACGATGCGGGAATGCT -> GCACGATGCGGGAATGCTG
GGGCGCTTCGTGGAGAACC -> GGCGCTTCGTGGAGAACCT
TATAAAAGAAGTGCAGGGT -> ATAAAAGAAGTGCAGGGTA
TATCGAGTGGCTCACCGTA -> ATCGAGTGGCTCACCGTAG
CAAACCCAGTAATCTAAAA -> AAACCCAGTAATCTAAAAA
GGAATGCTGGGTAAGACGG -> GAATGCTGGGTAAGACGGT
TTACTTGATCGGGGATCGG -> TACTTGATCGGGGATCGGT
ATATATGTTTGTCCTTAAA -> TATATGTTTGTCCTTAAAT
GAACCCACCTCCAGGATGT -> AACCCACCTCCAGGATGTC
TCTGCTAAAGGGCCACCAA -> CTGCTAAAGGGCCACCAAA
GCTGCAGGCAGGGGTACTC -> CTGCAGGCAGGGGTACTCG
CATGTGCAGTCGTCACGTC -> ATGTGCAGTCGTCACGTCT
TAGAGGTCGTCAGCTGGTG -> AGAGGTCGTCAGCTGGTGT
CCATAGCGGGATAAGAGCA -> CATAGCGGGATAAGAGCAC
CGTCTCCTCCTTATATCTT -> GTCTCCTCCTTATATCTTG
GAAGTTTTTCCTAGAAAAA -> AAGTTTTTCCTAGAAAAAA
TCCGAAATTCATGACCCCC -> CCGAAATTCATGACCCCCC
GCCCGGTTACCACGCACGA -> CCCGGTTACCACGCACGAT
TTCGCCCACTGCTAAATTC -> TCGCCCACTGCTAAATTCA
AATAATGAAGACCATCATG -> ATAATGAAGACCATCATGC
ATCAAGTGTACTTATGGTA -> TCAAGTGTACTTATGGTAG
CACCGATCCGTACTCTTAC -> ACCGATCCGTACTCTTACA
AACGCCAATTTGTCAGGCC -> ACGCCAATTTGTCAGGCCT
CGGACTATAGCATCACAAT -> GGACTATAGCATCACAATA
CCATGCGTTTCAACCGCGC -> CATGCGTTTCAACCGCGCT
AAGCTTTGCCGACGCCCCG -> AGCTTTGCCGACGCCCCGT
ATGCTAATAATAATAAGCC -> TGCTAATAATAATAAGCCA
TTTAAAGCCCAGCTTTGTT -> TTAAAGCCCAGCTTTGTTC
GTGACACAGGGCGTCTTGG -> TGACACAGGGCGTCTTGGC
GATTGTTGCTTACCGGCCT -> ATTGTTGCTTACCGGCCTG
TACAAACCGTATGTATAGC -> ACAAACCGTATGTATAGCT
TCCACGACCGATTTTTCCT -> CCACGACCGATTTTTCCTA
AGTAAGAGGCACCCGGCCG -> GTAAGAGGCACCCGGCCGC
GCCGGCCTGTCGAGACTCT -> CCGGCCTGTCGAGACTCTG
CCGAAAGTTACCCTAAGAT -> CGAAAGTTACCCTAAGATA
AAATACGGTTTAAAGCCCA -> AATACGGTTTAAAGCCCAG
TTGTCAGGCCTGAGCTACA -> TGTCAGGCCTGAGCTACAC
AGAGAACTTTCGAGTAATA -> GAGAACTTTCGAGTAATAG
ATCTGCCTCCTACCGTGTT -> TCTGCCTCCTACCGTGTTT
GGCCGTTTCCATGTGGGCG -> GCCGTTTCCATGTGGGCGA
CTTGCTCCCGGCCATACGG -> TTGCTCCCGGCCATACGGC
TTTCAACCGCGCTGCAGGC -> TTCAACCGCGCTGCAGGCA
AGACCCCTCAAACATATTG -> GACCCCTCAAACATATTGC
TACGGCTCCGACGGGCAGA -> ACGGCTCCGACGGGCAGAG
TCCTAGAAAAAAATACGAA -> CCTAGAAAAAAATACGAAA
TGCGAGGTATAAACCTTTG -> GCGAGGTATAAACCTTTGC
AGCCTGGACCGTAGCCACA -> GCCTGGACCGTAGCCACAC
TGAATCAACAAATCAGCAT -> GAATCAACAAATCAGCATG
ATGTTTGTCCTTAAATACG -> TGTTTGTCCTTAAATACGA
ACTAAGCCTGGACCGTAGC -> CTAAGCCTGGACCGTAGCC
ATTTGTCAGGCCTGAGCTA -> TTTGTCAGGCCTGAGCTAC
TGGTGATGTGCCAGGCTGT -> GGTGATGTGCCAGGCTGTT
AAAGAAGTGCAGGGTAAAG -> AAGAAGTGCAGGGTAAAGA
TGCCGACGCCCCGTCTGTA -> GCCGACGCCCCGTCTGTAT
ATGTTAAAAGTACGCTAAA -> TGTTAAAAGTACGCTAAAA
CTTACATTGTTCAAATGAC -> TTACATTGTTCAAATGACG
TAAAGGGCCACCAAAATGG -> AAAGGGCCACCAAAATGGC
TACTCTTACAGACTAATTA -> ACTCTTACAGACTAATTAA
GCGGGAAGTTCGCCTGTAC -> CGGGAAGTTCGCCTGTACA
TAAGTTTCGAGATCCCTTA -> AAGTTTCGAGATCCCTTAC
ACTCAATAATGAAGACCAT -> CTCAATAATGAAGACCATC
GACATGTAAAATGCTGGTT -> ACATGTAAAATGCTGGTTT
ATGGCTGGCTTCAGACCCT -> TGGCTGGCTTCAGACCCTT
GGCGTCTTGGCCGTTTCCA -> GCGTCTTGGCCGTTTCCAT
GGTAGCGGGAAGTTCGCCT -> GTAGCGGGAAGTTCGCCTG
GTCAACTGCGCAACAAGGG -> TCAACTGCGCAACAAGGGG
CGTATGTATAGCTTCGAGT -> GTATGTATAGCTTCGAGTC
GGCAGAGAAGCTTTGCCGA -> GCAGAGAAGCTTTGCCGAC
AATCTCAGACCCCTCAAAC -> ATCTCAGACCCCTCAAACA
ATTCCCAGCTGCCGGAATT -> TTCCCAGCTGCCGGAATTT
CAAAAATTCGAGCAGAACC -> AAAAATTCGAGCAGAACCC
CGCGATTCGTCTGCAAGAC -> GCGATTCGTCTGCAAGACA
TGTTGCTTACCGGCCTGTC -> GTTGCTTACCGGCCTGTCG
TGCTGGTTTCAATTGCTAG -> GCTGGTTTCAATTGCTAGT
TATTGCTGAGGCCGAATAG -> ATTGCTGAGGCCGAATAGC
CTCAATAATGAAGACCATC -> TCAATAATGAAGACCATCA
AACGGCGCACTTAGGATGA -> ACGGCGCACTTAGGATGAA
TCTCGTATGTCGTGTCCAT -> CTCGTATGTCGTGTCCATG
TAGAGTCGGGCCATGCCTA -> AGAGTCGGGCCATGCCTAC
GTCGTCACGTCTGCTAAAG -> TCGTCACGTCTGCTAAAGG
GGTGTCAAGGCAGCTTGAA -> GTGTCAAGGCAGCTTGAAC
CCGTATCAAGTGTACTTAT -> CGTATCAAGTGTACTTATG
CTTGAACTGTAAGGCCTTC -> TTGAACTGTAAGGCCTTCG
CCTTACATTGTTCAAATGA -> CTTACATTGTTCAAATGAC
GATCCGCGATTCGTCTGCA -> ATCCGCGATTCGTCTGCAA
GGGAAAATCTAGAGAACTT -> GGAAAATCTAGAGAACTTT
AATTTGTCAGGCCTGAGCT -> ATTTGTCAGGCCTGAGCTA
ATGTGAGCGCGGAGCCATG -> TGTGAGCGCGGAGCCATGT
CCGGCCGCCAAGAAATCTG -> CGGCCGCCAAGAAATCTGC
TGGTTGCCGATTCCGTATC -> GGTTGCCGATTCCGTATCG
ATCTTGTAGCCACGCTTCC -> TCTTGTAGCCACGCTTCCT
CGATTCCGTATCGTCTCCT -> GATTCCGTATCGTCTCCTC
CCTCCAGGATGTCATATTC -> CTCCAGGATGTCATATTCG
ATGTGACACAGGGCGTCTT -> TGTGACACAGGGCGTCTTG
GATCGGGGATCGGTCGACG -> ATCGGGGATCGGTCGACGC
CCCAGCTTTGTTCCTTGCG -> CCAGCTTTGTTCCTTGCGG
GATTTTTCCTAGAAAAAAA -> ATTTTTCCTAGAAAAAAAT
CTCAGACCCCTCAAACATA -> TCAGACCCCTCAAACATAT
ACCGTGTTTCATGAATCAA -> CCGTGTTTCATGAATCAAC
AGTTTTTCCTAGAAAAAAA -> GTTTTTCCTAGAAAAAAAT
GGGCGTCTTGGCCGTTTCC -> GGCGTCTTGGCCGTTTCCA
TATAGCATCACAATAGCGC -> ATAGCATCACAATAGCGCT
GATCCGTACTCTTACAGAC -> ATCCGTACTCTTACAGACT
AGCCACGCTTCCTATACCT -> GCCACGCTTCCTATACCTG
CCACTCAATAATGAAGACC -> CACTCAATAATGAAGACCA
GTCGTGTCCATGCTAATAA -> TCGTGTCCATGCTAATAAT
TCGCGGGTTATGGTCCTTT -> CGCGGGTTATGGTCCTTTA
AATTAGGGGTCAAACCCAG -> ATTAGGGGTCAAACCCAGT
GCAGTCGTCACGTCTGCTA -> CAGTCGTCACGTCTGCTAA
GTCGACGCCCTTGCTCCCG -> TCGACGCCCTTGCTCCCGG
GTTTCGAGATCCCTTACAT -> TTTCGAGATCCCTTACATT
GTAATCTAAAAAGCAATCC -> TAATCTAAAAAGCAATCCC
TACATTAGATGTGGGTAAT -> ACATTAGATGTGGGTAATT
TTCCTAGAAAAAAATACGG -> TCCTAGAAAAAAATACGGT
CACCCGACTCTCGCGCTCT -> ACCCGACTCTCGCGCTCTA
ATGACGTCACCGTCCATGG -> TGACGTCACCGTCCATGGG
GCTGGTTTCAATTGCTAGT -> CTGGTTTCAATTGCTAGTT
ATCGTCTCCTCCTTATATC -> TCGTCTCCTCCTTATATCT
GGAGCCCTTATCGAGTGGC -> GAGCCCTTATCGAGTGGCT
CGGTCGACGCCCTTGCTCC -> GGTCGACGCCCTTGCTCCC
CATTACCAACTTAGTCCGG -> ATTACCAACTTAGTCCGGA
GTGCAGGGTAAAGAAAAGA -> TGCAGGGTAAAGAAAAGAA
GCGACCTGTATACAGTTGG -> CGACCTGTATACAGTTGGT
CTACCGTGTTTCATGAATC -> TACCGTGTTTCATGAATCA
GGGAAGTTTTTCCTAGAAA -> GGAAGTTTTTCCTAGAAAA
ATCGGTCGACGCCCTTGCT -> TCGGTCGACGCCCTTGCTC
AGCTGGTGTCAAGGCAGCT -> GCTGGTGTCAAGGCAGCTT
AGTTTCGAGATCCCTTACA -> GTTTCGAGATCCCTTACAT
CGGTTTAAAGCCCAGCTTT -> GGTTTAAAGCCCAGCTTTG
CGCTTCGTGGAGAACCTCC -> GCTTCGTGGAGAACCTCCG
ACTAATAAGCAATCCGCTG -> CTAATAAGCAATCCGCTGA
CGAGACTCTTTGAAATGTC -> GAGACTCTTTGAAATGTCG
GCTAGTTCTACATCCTGTT -> CTAGTTCTACATCCTGTTA
GTCACCGTCCATGGGCCTA -> TCACCGTCCATGGGCCTAG
CTTTGCAAACAGGCGGATA -> TTTGCAAACAGGCGGATAG
ATACCCAGAAATAATGACA -> TACCCAGAAATAATGACAG
TTCAAATGACGTCACCGTC -> TCAAATGACGTCACCGTCC
ACCTTTGCAAACAGGCGGA -> CCTTTGCAAACAGGCGGAT
GGTCAAACCCAGTAATCTA -> GTCAAACCCAGTAATCTAA
CATTATCCGACATATCGTA -> ATTATCCGACATATCGTAA
TCTACAGTCAACTGCGCAA -> CTACAGTCAACTGCGCAAC
CGGCCTGTCGAGACTCTGC -> GGCCTGTCGAGACTCTGCC
GTCGAGACTCTCCACGACC -> TCGAGACTCTCCACGACCG
ATAGCGCTGATTGTTGCTT -> TAGCGCTGATTGTTGCTTA
AGCGACCTGTATACAGTTG -> GCGACCTGTATACAGTTGG
TGCCGGGAGCCCCCGTCGA -> GCCGGGAGCCCCCGTCGAC
TGGTGTCAAGGCAGCTTGA -> GGTGTCAAGGCAGCTTGAA
TTTTGCACAATATATGTTT -> TTTGCACAATATATGTTTG
GAGGCGTGTTGGCTCTTGA -> AGGCGTGTTGGCTCTTGAT
CGGGGATCGGTCGACGCCC -> GGGGATCGGTCGACGCCCT
TAAAGGTCACTGAATGTTA -> AAAGGTCACTGAATGTTAA
CGGCCGCCAAGAAATCTGC -> GGCCGCCAAGAAATCTGCC
CTAAAACGGATCGTACAAA -> TAAAACGGATCGTACAAAC
GCGCTTCGTGGAGAACCTC -> CGCTTCGTGGAGAACCTCC
CCTGTACATGTGCAGTCGT -> CTGTACATGTGCAGTCGTC
CTCGATTAAAGGTCACTGA -> TCGATTAAAGGTCACTGAA
ATGAACTCTGGGTGAGGCG -> TGAACTCTGGGTGAGGCGT
CGTATCAAGTGTACTTATG -> GTATCAAGTGTACTTATGG
GCAGAATACTATGTGGGCC -> CAGAATACTATGTGGGCCG
CGGCTGTTGTTGTTCCCGA -> GGCTGTTGTTGTTCCCGAA
ACAGTTGGTTGCCGATTCC -> CAGTTGGTTGCCGATTCCG
TAAACCTTTGCAAACAGGC -> AAACCTTTGCAAACAGGCG
GAAATAATGACAGGTCCGG -> AAATAATGACAGGTCCGGC
GTTACCACGCACGATGCGG -> TTACCACGCACGATGCGGG
ATTTTTCCTAGAAAAAAAT -> TTTTTCCTAGAAAAAAATA
CGTATCGTCTCCTCCTTAT -> GTATCGTCTCCTCCTTATA
ATGTCGTTTTCCTAGAAAA -> TGTCGTTTTCCTAGAAAAA
GTGATGTGCCAGGCTGTTC -> TGATGTGCCAGGCTGTTCT
TGGCCCGGTTACCACGCAC -> GGCCCGGTTACCACGCACG
AACCCAAATGTGAGCGCGG -> ACCCAAATGTGAGCGCGGA
CAACCGCGCTGCAGGCAGG -> AACCGCGCTGCAGGCAGGG
ATTCGAGCAGAACCCAAAT -> TTCGAGCAGAACCCAAATG
CAGACCCTTATCACAAAAA -> AGACCCTTATCACAAAAAT
GACCGATTTTTCCTAGAAA -> ACCGATTTTTCCTAGAAAA
CATGATGGGAGCCCTTATC -> ATGATGGGAGCCCTTATCG
TTCGACAGTCCGAAATTCA -> TCGACAGTCCGAAATTCAT
TTAGTAAGAGGCACCCGGC -> TAGTAAGAGGCACCCGGCC
CGGCGCACTTAGGATGAAC -> GGCGCACTTAGGATGAACT
GCCTGTCGAGACTCTAACA -> CCTGTCGAGACTCTAACAT
CTCTCAGTCATTATCCGAC -> TCTCAGTCATTATCCGACA
TGATCCGCGATTCGTCTGC -> GATCCGCGATTCGTCTGCA
CTATGTGGGCCGCCTCCCA -> TATGTGGGCCGCCTCCCAG
GGTTGCCGATTCCGTATCG -> GTTGCCGATTCCGTATCGT
CTGTCGAGACTCTAACATG -> TGTCGAGACTCTAACATGG
CCAGATTCGACAGTCCGAA -> CAGATTCGACAGTCCGAAA
TCCTAGAAAAAAATACACG -> CCTAGAAAAAAATACACGT
AAAAGTACGCTAAAACCAG -> AAAGTACGCTAAAACCAGA
GCTTCTAGTCCGCGCATGA -> CTTCTAGTCCGCGCATGAT
GATGTGCCAGGCTGTTCTT -> ATGTGCCAGGCTGTTCTTC
CTTATTGATCTTCGCCCAC -> TTATTGATCTTCGCCCACT
AAAAAAATACACGTCTACG -> AAAAAATACACGTCTACGC
AATGTCGTTTTCCTAGAAA -> ATGTCGTTTTCCTAGAAAA
GGTCACTGAATGTTAAAAG -> GTCACTGAATGTTAAAAGT
CTCCACGACCGATTTTTCC -> TCCACGACCGATTTTTCCT
TCCGACATATCGTAAATTC -> CCGACATATCGTAAATTCG
CTTATCGAGTGGCTCACCG -> TTATCGAGTGGCTCACCGT
TAATGGCGACACCCTACTA -> AATGGCGACACCCTACTAG
TTGCCGGGAGCCCCCGTCG -> TGCCGGGAGCCCCCGTCGA
CTCATTACCAACTTAGTCC -> TCATTACCAACTTAGTCCG
CGCTGATTGTTGCTTACCG -> GCTGATTGTTGCTTACCGG
CGATTAAAGGTCACTGAAT -> GATTAAAGGTCACTGAATG
GAAAAAAATACGGTTTAAA -> AAAAAAATACGGTTTAAAG
ATCTAAAAAGCAATCCCTT -> TCTAAAAAGCAATCCCTTG
GAGATGGCCCGGTTACCAC -> AGATGGCCCGGTTACCACG
CCTTTAAATCTCAGACCCC -> CTTTAAATCTCAGACCCCT
AGCCCCCGTCGACAAACAA -> GCCCCCGTCGACAAACAAG
TCTGTATGCCGGCTGTTGT -> CTGTATGCCGGCTGTTGTT
GCGGGATAAGAGCACCCGA -> CGGGATAAGAGCACCCGAC
CGCTACACGTTACTTGATC -> GCTACACGTTACTTGATCG
GGCTGTTCTTCACCATATC -> GCTGTTCTTCACCATATCA
GGAAATATAATTAGGGGTC -> GAAATATAATTAGGGGTCA
CCGACTCTCGCGCTCTACA -> CGACTCTCGCGCTCTACAG
CTCTGCCAGGGAAGTTTTT -> TCTGCCAGGGAAGTTTTTC
GGTGATGTGCCAGGCTGTT -> GTGATGTGCCAGGCTGTTC
GTGAGCGTAACAGGTCACC -> TGAGCGTAACAGGTCACCT
GGATAAGAGCACCCGACTC -> GATAAGAGCACCCGACTCT
GATCGTACAAACCGTATGT -> ATCGTACAAACCGTATGTA
CAGATTCGACAGTCCGAAA -> AGATTCGACAGTCCGAAAT
AAAAGCAATCCCTTGAACT -> AAAGCAATCCCTTGAACTG
GATTCGACAGTCCGAAATT -> ATTCGACAGTCCGAAATTC
TATTGATCTTCGCCCACTG -> ATTGATCTTCGCCCACTGC
GTAAATTCGGCTCCTATGC -> TAAATTCGGCTCCTATGCT
TTTGAAATGTCGTTTTCCT -> TTGAAATGTCGTTTTCCTA
GAATCAACAAATCAGCATG -> AATCAACAAATCAGCATGC
TTCCTAGAAAAAAATACCC -> TCCTAGAAAAAAATACCCA
TAATAAGCCATAGCGGGAT -> AATAAGCCATAGCGGGATA
TAGGGGGGGATATCGCTAC -> AGGGGGGGATATCGCTACA
TTGATCTTCGCCCACTGCT -> TGATCTTCGCCCACTGCTA
TTCTTCACCATATCACAAC -> TCTTCACCATATCACAACG
AAAAATACGAAAGGCACGC -> AAAATACGAAAGGCACGCT
AAGAAGGGTATTGCTTATG -> AGAAGGGTATTGCTTATGC
AAAAAATACGGTTTAAAGC -> AAAAATACGGTTTAAAGCC
GGTTAGCAGAATACTATGT -> GTTAGCAGAATACTATGTG
TTTCCTAGAAAAAAATACG -> TTCCTAGAAAAAAATACGG,TTCCTAGAAAAAAATACGA
CCAAAATGGCTGGCTTCAG -> CAAAATGGCTGGCTTCAGA
TATGCTAAGACTAATAAGC -> ATGCTAAGACTAATAAGCA
CGTGGAGAACCTCCGTATC -> GTGGAGAACCTCCGTATCA
GGGTATTGCTTATGCGAGG -> GGTATTGCTTATGCGAGGT
CTACAGTCAACTGCGCAAC -> TACAGTCAACTGCGCAACA
TACCCTAAGATAAGTTTCG -> ACCCTAAGATAAGTTTCGA
TTATGCGAGGTATAAACCT -> TATGCGAGGTATAAACCTT
CCATACGGCTCCGACGGGC -> CATACGGCTCCGACGGGCA
CTGTTACGCCGTATACGTC -> TGTTACGCCGTATACGTCG
TCGCCCACTGCTAAATTCA -> CGCCCACTGCTAAATTCAG
AATTGCTAGTTCTACATCC -> ATTGCTAGTTCTACATCCT
GGGCCACCAAAATGGCTGG -> GGCCACCAAAATGGCTGGC
AATAGCGCTGATTGTTGCT -> ATAGCGCTGATTGTTGCTT
GAGACTCTCCACGACCGAT -> AGACTCTCCACGACCGATT
CTGTACATGTGCAGTCGTC -> TGTACATGTGCAGTCGTCA
TAATGAAGACCATCATGCT -> AATGAAGACCATCATGCTA
GTCTGTATGCCGGCTGTTG -> TCTGTATGCCGGCTGTTGT
ACTCGATTAAAGGTCACTG -> CTCGATTAAAGGTCACTGA
AAAATGGCTGGCTTCAGAC -> AAATGGCTGGCTTCAGACC
CTCGGGCGCTTCGTGGAGA -> TCGGGCGCTTCGTGGAGAA
CCCTTACATTGTTCAAATG -> CCTTACATTGTTCAAATGA
CAGCTGCCGGAATTTACTC -> AGCTGCCGGAATTTACTCT
ATACGTCGAGATGGCCCGG -> TACGTCGAGATGGCCCGGT
TGCTTACCGGCCTGTCGAG -> GCTTACCGGCCTGTCGAGA
TCGAGACTCTGCCAGGGAA -> CGAGACTCTGCCAGGGAAG
GCGTGGACAGATCCAAGCA -> CGTGGACAGATCCAAGCAA
CCCTACTAGTCGGACTATA -> CCTACTAGTCGGACTATAG
GAAGTGCAGGGTAAAGAAA -> AAGTGCAGGGTAAAGAAAA
TGACCCCCCCTCGGGCGCT -> GACCCCCCCTCGGGCGCTT
AGCCCTTATCGAGTGGCTC -> GCCCTTATCGAGTGGCTCA
TGGTTTCAATTGCTAGTTC -> GGTTTCAATTGCTAGTTCT
ATGACAGGTCCGGCCTGTC -> TGACAGGTCCGGCCTGTCG
AAAGGTCACTGAATGTTAA -> AAGGTCACTGAATGTTAAA
TTGTAGCCACGCTTCCTAT -> TGTAGCCACGCTTCCTATA
AAACCCAGTAATCTAAAAA -> AACCCAGTAATCTAAAAAG
GCCGCCAAGAAATCTGCCT -> CCGCCAAGAAATCTGCCTC
CAGGTCACCTTATTGATCT -> AGGTCACCTTATTGATCTT
GCCCACTGCTAAATTCAGC -> CCCACTGCTAAATTCAGCA
CTACACGACCCCTGGGGCT -> TACACGACCCCTGGGGCTT
TTTCGAGATCCCTTACATT -> TTCGAGATCCCTTACATTG
AAGAAGTGCAGGGTAAAGA -> AGAAGTGCAGGGTAAAGAA
AGGGGTTTTGCACAATATA -> GGGGTTTTGCACAATATAT
TATCCGACATATCGTAAAT -> ATCCGACATATCGTAAATT
CATGTAAAATGCTGGTTTC -> ATGTAAAATGCTGGTTTCA
GTAGACTCGTGACACGGTG -> TAGACTCGTGACACGGTGT
TGTTAAAAGTACGCTAAAA -> GTTAAAAGTACGCTAAAAC
AGACCCTTATCACAAAAAT -> GACCCTTATCACAAAAATT
TCCTATGCTAAGACTAATA -> CCTATGCTAAGACTAATAA
GCACAATATATGTTTGTCC -> CACAATATATGTTTGTCCT
CCTATACCTGGTTAGCAGA -> CTATACCTGGTTAGCAGAA
GCTTACCGGCCTGTCGAGA -> CTTACCGGCCTGTCGAGAC
GTCCTTAAATACGACATGT -> TCCTTAAATACGACATGTA
CTCTCGCGCTCTACAGTCA -> TCTCGCGCTCTACAGTCAA
ACTTAGTCCGGATCGTCTC -> CTTAGTCCGGATCGTCTCT
TGGCTCTTGATTAGGCTGA -> GGCTCTTGATTAGGCTGAA
CTCCCGGCCATACGGCTCC -> TCCCGGCCATACGGCTCCG
CCATGCTAATAATAATAAG -> CATGCTAATAATAATAAGC
CCGGCTGTGCGTGGACAGA -> CGGCTGTGCGTGGACAGAT
AATTCGAGCAGAACCCAAA -> ATTCGAGCAGAACCCAAAT
ATGCTAATGGCGACACCCT -> TGCTAATGGCGACACCCTA
TCGAGATCCCTTACATTGT -> CGAGATCCCTTACATTGTT
AAGCCACTCAATAATGAAG -> AGCCACTCAATAATGAAGA
AGGGCTTGAGATTATATTG -> GGGCTTGAGATTATATTGG
TGCCTTAGTAAGAGGCACC -> GCCTTAGTAAGAGGCACCC
AGTCGGGCCATGCCTACTA -> GTCGGGCCATGCCTACTAA
TTGTTCCCGAAAGTTACCC -> TGTTCCCGAAAGTTACCCT
ACAGGTCCGGCCTGTCGAG -> CAGGTCCGGCCTGTCGAGA
ACTCTGCCAGGGAAGTTTT -> CTCTGCCAGGGAAGTTTTT
TTGAACTGTAAGGCCTTCG -> TGAACTGTAAGGCCTTCGC
CGGCTGTGCGTGGACAGAT -> GGCTGTGCGTGGACAGATC
GACCCCTCAAACATATTGC -> ACCCCTCAAACATATTGCT
ACATATTGCTGAGGCCGAA -> CATATTGCTGAGGCCGAAT
TCATTACCAACTTAGTCCG -> CATTACCAACTTAGTCCGG
TCGGGGATCGGTCGACGCC -> CGGGGATCGGTCGACGCCC
CACAAAAATTCGAGCAGAA -> ACAAAAATTCGAGCAGAAC
AATAGCGACCTGTATACAG -> ATAGCGACCTGTATACAGT
CGTCACGTCTGCTAAAGGG -> GTCACGTCTGCTAAAGGGC
ATTCGGCTCCTATGCTAAG -> TTCGGCTCCTATGCTAAGA
AATCCCTTGAACTGTAAGG -> ATCCCTTGAACTGTAAGGC
CAAACAAGCCACTCAATAA -> AAACAAGCCACTCAATAAT
AGATAAGTTTCGAGATCCC -> GATAAGTTTCGAGATCCCT
CGCGGAGCCATGTGACACA -> GCGGAGCCATGTGACACAG
TCTCGCGCTCTACAGTCAA -> CTCGCGCTCTACAGTCAAC
GTATCAAGTGTACTTATGG -> TATCAAGTGTACTTATGGT
AATGTTAAAAGTACGCTAA -> ATGTTAAAAGTACGCTAAA
TCGCCTGTACATGTGCAGT -> CGCCTGTACATGTGCAGTC
GGCCTGTCGAGACTCTGCC -> GCCTGTCGAGACTCTGCCA
GATCGTCTCTCAGTCATTA -> ATCGTCTCTCAGTCATTAT
ATATCTTGTAGCCACGCTT -> TATCTTGTAGCCACGCTTC
TATGGTAGCGGGAAGTTCG -> ATGGTAGCGGGAAGTTCGC
TAGTTCTACATCCTGTTAC -> AGTTCTACATCCTGTTACG
AGAAAAAAATACCCAGAAA -> GAAAAAAATACCCAGAAAT
ATGGTAGCGGGAAGTTCGC -> TGGTAGCGGGAAGTTCGCC
TGAGCGTAACAGGTCACCT -> GAGCGTAACAGGTCACCTT
GTCGACAAACAAGCCACTC -> TCGACAAACAAGCCACTCA
TTCGTTTTCCTAGAAAAAA -> TCGTTTTCCTAGAAAAAAA
TAGCGACCTGTATACAGTT -> AGCGACCTGTATACAGTTG
ACTCTATAAAAGAAGTGCA -> CTCTATAAAAGAAGTGCAG
AGCTAAAACGGATCGTACA -> GCTAAAACGGATCGTACAA
ACATCCTGTTACGCCGTAT -> CATCCTGTTACGCCGTATA
ATTGCTGAGGCCGAATAGC -> TTGCTGAGGCCGAATAGCG
AGAAATAATGACAGGTCCG -> GAAATAATGACAGGTCCGG
GCAGGCAGGGGTACTCGAT -> CAGGCAGGGGTACTCGATT
ATAGCTTCGAGTCGATGCC -> TAGCTTCGAGTCGATGCCG
GAGATCCCTTACATTGTTC -> AGATCCCTTACATTGTTCA
TCACCGTCCATGGGCCTAG -> CACCGTCCATGGGCCTAGA
TTCCTATACCTGGTTAGCA -> TCCTATACCTGGTTAGCAG
AACAAATCAGCATGCTCAG -> ACAAATCAGCATGCTCAGC
CGTCTACGCGACCATGCGT -> GTCTACGCGACCATGCGTT
CCTGTCGAGACTCTAACAT -> CTGTCGAGACTCTAACATG
TAAATTCGGCTCCTATGCT -> AAATTCGGCTCCTATGCTA
TAGAAAAAAATACCCAGAA -> AGAAAAAAATACCCAGAAA
GTTACTTGATCGGGGATCG -> TTACTTGATCGGGGATCGG
GGCACGCTGCAAACGCTTT -> GCACGCTGCAAACGCTTTG
AATAATGACAGGTCCGGCC -> ATAATGACAGGTCCGGCCT
GTGCCAGGCTGTTCTTCAC -> TGCCAGGCTGTTCTTCACC
CACCCTACTAGTCGGACTA -> ACCCTACTAGTCGGACTAT
TGTTGGCTCTTGATTAGGC -> GTTGGCTCTTGATTAGGCT
CCCACCTCCAGGATGTCAT -> CCACCTCCAGGATGTCATA
GAATAGCGACCTGTATACA -> AATAGCGACCTGTATACAG
CAATCCCTTGAACTGTAAG -> AATCCCTTGAACTGTAAGG
ATAATAATAAGCCATAGCG -> TAATAATAAGCCATAGCGG
TAACATGGTTCGTTTTCCT -> AACATGGTTCGTTTTCCTA
CGCTGCAGGCAGGGGTACT -> GCTGCAGGCAGGGGTACTC
AGTCCGAAATTCATGACCC -> GTCCGAAATTCATGACCCC
TATTCGTATGGCCGGCTGT -> ATTCGTATGGCCGGCTGTG
GTCGAGACTCTAACATGGT -> TCGAGACTCTAACATGGTT
TTGCAAACAGGCGGATAGC -> TGCAAACAGGCGGATAGCT
CCGCCAAGAAATCTGCCTC -> CGCCAAGAAATCTGCCTCC
CGTTACTTGATCGGGGATC -> GTTACTTGATCGGGGATCG
AAATCTGCCTCCTACCGTG -> AATCTGCCTCCTACCGTGT
CAGTCCGAAATTCATGACC -> AGTCCGAAATTCATGACCC
AAGTACGCTAAAACCAGAT -> AGTACGCTAAAACCAGATT
GATAAGAGCACCCGACTCT -> ATAAGAGCACCCGACTCTC
GCGAAGATCTCGTATGTCG -> CGAAGATCTCGTATGTCGT
ACTGTAAGGCCTTCGCGGG -> CTGTAAGGCCTTCGCGGGT
GCATGCTCAGCTAAAACGG -> CATGCTCAGCTAAAACGGA
TTCCGTATCGTCTCCTCCT -> TCCGTATCGTCTCCTCCTT
GGCCTTCGCGGGTTATGGT -> GCCTTCGCGGGTTATGGTC
CTGAATGTTAAAAGTACGC -> TGAATGTTAAAAGTACGCT
GAGACTCTTTGAAATGTCG -> AGACTCTTTGAAATGTCGT
ACGCTGCAAACGCTTTGAT -> CGCTGCAAACGCTTTGATC
TTAAACGCCAATTTGTCAG -> TAAACGCCAATTTGTCAGG
TCCTGTTACGCCGTATACG -> CCTGTTACGCCGTATACGT
CCACTGCTAAATTCAGCAG -> CACTGCTAAATTCAGCAGC
CAAGTGTACTTATGGTAGC -> AAGTGTACTTATGGTAGCG
GGGTTATGGTCCTTTAAAT -> GGTTATGGTCCTTTAAATC
GACCCCCCCTCGGGCGCTT -> ACCCCCCCTCGGGCGCTTC
AACCTCCGTATCAAGTGTA -> ACCTCCGTATCAAGTGTAC
AACAGGTCACCTTATTGAT -> ACAGGTCACCTTATTGATC
CAGGTCCGGCCTGTCGAGA -> AGGTCCGGCCTGTCGAGAC
AATGCTGGGTAAGACGGTA -> ATGCTGGGTAAGACGGTAG
TGGAGAACCTCCGTATCAA -> GGAGAACCTCCGTATCAAG
AGGATCACAATTCCCAGCT -> GGATCACAATTCCCAGCTG
GGCCGCCTCCCAGGGCTTG -> GCCGCCTCCCAGGGCTTGA
TAGGCTGAACCCACCTCCA -> AGGCTGAACCCACCTCCAG
GGGCAGAGAAGCTTTGCCG -> GGCAGAGAAGCTTTGCCGA
AATCAGCATGCTCAGCTAA -> ATCAGCATGCTCAGCTAAA
CCCAGAAATAATGACAGGT -> CCAGAAATAATGACAGGTC
GATTCGTCTGCAAGACATG -> ATTCGTCTGCAAGACATGA
CGCTTTGATCCGCGATTCG -> GCTTTGATCCGCGATTCGT
AAGGGTATTGCTTATGCGA -> AGGGTATTGCTTATGCGAG
TCTCCACGACCGATTTTTC -> CTCCACGACCGATTTTTCC
TCAAGTGTACTTATGGTAG -> CAAGTGTACTTATGGTAGC
TACACGACCCCTGGGGCTT -> ACACGACCCCTGGGGCTTC
CCGTATACGTCGAGATGGC -> CGTATACGTCGAGATGGCC
GATGCCGGCCTGTCGAGAC -> ATGCCGGCCTGTCGAGACT
CGTATGGCCGGCTGTGCGT -> GTATGGCCGGCTGTGCGTG
AGTTACCCTAAGATAAGTT -> GTTACCCTAAGATAAGTTT
AGTAATAGAGGTCGTCAGC -> GTAATAGAGGTCGTCAGCT
ACTCTCGCGCTCTACAGTC -> CTCTCGCGCTCTACAGTCA
ATGTCATATTCGTATGGCC -> TGTCATATTCGTATGGCCG
TCATGACCCCCCCTCGGGC -> CATGACCCCCCCTCGGGCG
TCGATTAAAGGTCACTGAA -> CGATTAAAGGTCACTGAAT
TCGGCTCCTATGCTAAGAC -> CGGCTCCTATGCTAAGACT
CACGACCGATTTTTCCTAG -> ACGACCGATTTTTCCTAGA
AAGTTCGCCTGTACATGTG -> AGTTCGCCTGTACATGTGC
AATACTATGTGGGCCGCCT -> ATACTATGTGGGCCGCCTC
GGCAGGGGTACTCGATTAA -> GCAGGGGTACTCGATTAAA
CCATGTGACACAGGGCGTC -> CATGTGACACAGGGCGTCT
GGTATTGCTTATGCGAGGT -> GTATTGCTTATGCGAGGTA
GTGTTGGCTCTTGATTAGG -> TGTTGGCTCTTGATTAGGC
CACGCTTCCTATACCTGGT -> ACGCTTCCTATACCTGGTT
GGGCCATGCCTACTAAGCC -> GGCCATGCCTACTAAGCCT
ATCGTCTCTCAGTCATTAT -> TCGTCTCTCAGTCATTATC
ATATCGCTACACGTTACTT -> TATCGCTACACGTTACTTG
ATTGGTGATGTGCCAGGCT -> TTGGTGATGTGCCAGGCTG
ACCGTAGACTCGTGACACG -> CCGTAGACTCGTGACACGG
ACAACGGCGCACTTAGGAT -> CAACGGCGCACTTAGGATG
ACAAATCAGCATGCTCAGC -> CAAATCAGCATGCTCAGCT
CAGGGAAGTTTTTCCTAGA -> AGGGAAGTTTTTCCTAGAA
ACACGTTACTTGATCGGGG -> CACGTTACTTGATCGGGGA
TGTGGGCCGCCTCCCAGGG -> GTGGGCCGCCTCCCAGGGC
GTATGGCCGGCTGTGCGTG -> TATGGCCGGCTGTGCGTGG
GACAGTCCGAAATTCATGA -> ACAGTCCGAAATTCATGAC
TCGAGACTCTCCACGACCG -> CGAGACTCTCCACGACCGA
TCAGCTAAAACGGATCGTA -> CAGCTAAAACGGATCGTAC
CGTCTTGGCCGTTTCCATG -> GTCTTGGCCGTTTCCATGT
GAGCCCCGGCCTGTCGAGA -> AGCCCCGGCCTGTCGAGAC
TGCAAACAGGCGGATAGCT -> GCAAACAGGCGGATAGCTC
CAGGGCTTGAGATTATATT -> AGGGCTTGAGATTATATTG
CTGTCGAGACTCTTTGAAA -> TGTCGAGACTCTTTGAAAT
GACCTGTATACAGTTGGTT -> ACCTGTATACAGTTGGTTG
TTATTGATCTTCGCCCACT -> TATTGATCTTCGCCCACTG
TTGCTCCCGGCCATACGGC -> TGCTCCCGGCCATACGGCT
GTTGTTGTTCCCGAAAGTT -> TTGTTGTTCCCGAAAGTTA
TTGGTGATGTGCCAGGCTG -> TGGTGATGTGCCAGGCTGT
CTAACATGGTTCGTTTTCC -> TAACATGGTTCGTTTTCCT
AGGCCGAATAGCGACCTGT -> GGCCGAATAGCGACCTGTA
ATCTCGTATGTCGTGTCCA -> TCTCGTATGTCGTGTCCAT
CATGCTCAGCTAAAACGGA -> ATGCTCAGCTAAAACGGAT
TTTCCTAGAAAAAAATACC -> TTCCTAGAAAAAAATACCC
GGCTGTGCGTGGACAGATC -> GCTGTGCGTGGACAGATCC
CCCTAAGATAAGTTTCGAG -> CCTAAGATAAGTTTCGAGA
ACCCCCCCTCGGGCGCTTC -> CCCCCCCTCGGGCGCTTCG
GAGGTATAAACCTTTGCAA -> AGGTATAAACCTTTGCAAA
ATGCCTACTAAGCCTGGAC -> TGCCTACTAAGCCTGGACC
AACCCACCTCCAGGATGTC -> ACCCACCTCCAGGATGTCA
GCGCTGCAGGCAGGGGTAC -> CGCTGCAGGCAGGGGTACT
TGCTAATGGCGACACCCTA -> GCTAATGGCGACACCCTAC
GGGTACTCGATTAAAGGTC -> GGTACTCGATTAAAGGTCA
AATAAGCAATCCGCTGATG -> ATAAGCAATCCGCTGATGA
TTGAACTTTGCCGGGAGCC -> TGAACTTTGCCGGGAGCCC
GTAACAGGTCACCTTATTG -> TAACAGGTCACCTTATTGA
CCAGGCTGTTCTTCACCAT -> CAGGCTGTTCTTCACCATA
TGCTGGGTAAGACGGTAGG -> GCTGGGTAAGACGGTAGGA
GGCGAAGATCTCGTATGTC -> GCGAAGATCTCGTATGTCG
CCCGGCCATACGGCTCCGA -> CCGGCCATACGGCTCCGAC
TCGTGACACGGTGTACAAT -> CGTGACACGGTGTACAATG
CTGGCTTCAGACCCTTATC -> TGGCTTCAGACCCTTATCA
GCTGAGGCCGAATAGCGAC -> CTGAGGCCGAATAGCGACC
AGAAAAAAATACGGTTTAA -> GAAAAAAATACGGTTTAAA
GAGTGAGCGTAACAGGTCA -> AGTGAGCGTAACAGGTCAC
TTGTTCAAATGACGTCACC -> TGTTCAAATGACGTCACCG
AAGCCCAGCTTTGTTCCTT -> AGCCCAGCTTTGTTCCTTG
CTTCACCATATCACAACGG -> TTCACCATATCACAACGGC
CAGGCAGGGGTACTCGATT -> AGGCAGGGGTACTCGATTA
CAGAACCCAAATGTGAGCG -> AGAACCCAAATGTGAGCGC
TGGCGACACCCTACTAGTC -> GGCGACACCCTACTAGTCG
GCCCCGGCCTGTCGAGACT -> CCCCGGCCTGTCGAGACTC
TGATGGGAGCCCTTATCGA -> GATGGGAGCCCTTATCGAG
CCGGCCTGTCGAGACTCTC -> CGGCCTGTCGAGACTCTCC
CTGATGAAGTGCCTTAGTA -> TGATGAAGTGCCTTAGTAA
TTTTTCCTAGAAAAAAATA -> TTTTCCTAGAAAAAAATAC,TTTTCCTAGAAAAAAATAC
CCTAGAGTCGGGCCATGCC -> CTAGAGTCGGGCCATGCCT
GTCAGCTGGTGTCAAGGCA -> TCAGCTGGTGTCAAGGCAG
GCCTGTCGAGACTCTTTGA -> CCTGTCGAGACTCTTTGAA
TGGGCGAAGATCTCGTATG -> GGGCGAAGATCTCGTATGT
CCGCGCTGCAGGCAGGGGT -> CGCGCTGCAGGCAGGGGTA
AAAAAAATACGGTTTAAAG -> AAAAAATACGGTTTAAAGC
CTTCTAGTCCGCGCATGAT -> TTCTAGTCCGCGCATGATG
ACTGAATGTTAAAAGTACG -> CTGAATGTTAAAAGTACGC
TTGCACAATATATGTTTGT -> TGCACAATATATGTTTGTC
CAAGCAATACATTAGATGT -> AAGCAATACATTAGATGTG
ATTAAAGGTCACTGAATGT -> TTAAAGGTCACTGAATGTT
CCCCTGGGGCTTCTAGTCC -> CCCTGGGGCTTCTAGTCCG
GACCGTAGCCACACCGATC -> ACCGTAGCCACACCGATCC
TTGCCGACGCCCCGTCTGT -> TGCCGACGCCCCGTCTGTA
TTCGAGCAGAACCCAAATG -> TCGAGCAGAACCCAAATGT
TAGCTTCGAGTCGATGCCG -> AGCTTCGAGTCGATGCCGG
AAAAAATACCCAGAAATAA -> AAAAATACCCAGAAATAAT
CCGTGTTTCATGAATCAAC -> CGTGTTTCATGAATCAACA
TAATGACAGGTCCGGCCTG -> AATGACAGGTCCGGCCTGT
CGTACTCTTACAGACTAAT -> GTACTCTTACAGACTAATT
CTCACCGTAGACTCGTGAC -> TCACCGTAGACTCGTGACA
TATACGTCGAGATGGCCCG -> ATACGTCGAGATGGCCCGG
AGCTTTGCCGACGCCCCGT -> GCTTTGCCGACGCCCCGTC
CGAGATCCCTTACATTGTT -> GAGATCCCTTACATTGTTC
TCGACAAACAAGCCACTCA -> CGACAAACAAGCCACTCAA
AAAAAAATACCCAGAAATA -> AAAAAATACCCAGAAATAA
GTCTCCTCCTTATATCTTG -> TCTCCTCCTTATATCTTGT
CGGGAAAATCTAGAGAACT -> GGGAAAATCTAGAGAACTT
CTATGCTAAGACTAATAAG -> TATGCTAAGACTAATAAGC
TATCTTGTAGCCACGCTTC -> ATCTTGTAGCCACGCTTCC
CAGTCAACTGCGCAACAAG -> AGTCAACTGCGCAACAAGG
GCCACTCAATAATGAAGAC -> CCACTCAATAATGAAGACC
TAAAAGAAGTGCAGGGTAA -> AAAAGAAGTGCAGGGTAAA
ACGGTAGGATCACAATTCC -> CGGTAGGATCACAATTCCC
TTCAGCAGCCGTAGGGGGG -> TCAGCAGCCGTAGGGGGGG
CGGTAGGATCACAATTCCC -> GGTAGGATCACAATTCCCA
TTACTCTATAAAAGAAGTG -> TACTCTATAAAAGAAGTGC
ATTAGATGTGGGTAATTGA -> TTAGATGTGGGTAATTGAG
CGAGATGGCCCGGTTACCA -> GAGATGGCCCGGTTACCAC
GACCATCATGCTAATGGCG -> ACCATCATGCTAATGGCGA
CTGCCAGGGAAGTTTTTCC -> TGCCAGGGAAGTTTTTCCT
CGTAACAGGTCACCTTATT -> GTAACAGGTCACCTTATTG
GTCCGGCCTGTCGAGACTC -> TCCGGCCTGTCGAGACTCT
GACGGTAGGATCACAATTC -> ACGGTAGGATCACAATTCC
CCGGAATTTACTCTATAAA -> CGGAATTTACTCTATAAAA
AGCAATCCCTTGAACTGTA -> GCAATCCCTTGAACTGTAA
GGTTTCAATTGCTAGTTCT -> GTTTCAATTGCTAGTTCTA
GAAAAGAAGGGTATTGCTT -> AAAAGAAGGGTATTGCTTA
CGTCTGTATGCCGGCTGTT -> GTCTGTATGCCGGCTGTTG
CAGGCTGTTCTTCACCATA -> AGGCTGTTCTTCACCATAT
CACAATAGCGCTGATTGTT -> ACAATAGCGCTGATTGTTG
CCAGTAATCTAAAAAGCAA -> CAGTAATCTAAAAAGCAAT
GACAGATCCAAGCAATACA -> ACAGATCCAAGCAATACAT
GCTGGTGTCAAGGCAGCTT -> CTGGTGTCAAGGCAGCTTG
CTCTAACATGGTTCGTTTT -> TCTAACATGGTTCGTTTTC
TGGGCCTAGAGTCGGGCCA -> GGGCCTAGAGTCGGGCCAT
GGCCATACGGCTCCGACGG -> GCCATACGGCTCCGACGGG
TTACCGGCCTGTCGAGACT -> TACCGGCCTGTCGAGACTC
AAATTCAGCAGCCGTAGGG -> AATTCAGCAGCCGTAGGGG
GAGTCGATGCCGGCCTGTC -> AGTCGATGCCGGCCTGTCG
GCCTGTCGAGACTCTGCCA -> CCTGTCGAGACTCTGCCAG
CATTAGATGTGGGTAATTG -> ATTAGATGTGGGTAATTGA
GCCTCCTACCGTGTTTCAT -> CCTCCTACCGTGTTTCATG
CCAACTTAGTCCGGATCGT -> CAACTTAGTCCGGATCGTC
ACCGGCCTGTCGAGACTCT -> CCGGCCTGTCGAGACTCTA
CAAATGTGAGCGCGGAGCC -> AAATGTGAGCGCGGAGCCA
CGGTTACCACGCACGATGC -> GGTTACCACGCACGATGCG
ATATTCGTATGGCCGGCTG -> TATTCGTATGGCCGGCTGT
GCTAAAGGGCCACCAAAAT -> CTAAAGGGCCACCAAAATG
GTGCAGTCGTCACGTCTGC -> TGCAGTCGTCACGTCTGCT
CACGACCCCTGGGGCTTCT -> ACGACCCCTGGGGCTTCTA
CCTCCTTATATCTTGTAGC -> CTCCTTATATCTTGTAGCC
GAAAAAAATACACGTCTAC -> AAAAAAATACACGTCTACG
TACTAAGCCTGGACCGTAG -> ACTAAGCCTGGACCGTAGC
TATCACAAAAATTCGAGCA -> ATCACAAAAATTCGAGCAG
CGCCTCCCAGGGCTTGAGA -> GCCTCCCAGGGCTTGAGAT
GGGTAAAGAAAAGAAGGGT -> GGTAAAGAAAAGAAGGGTA
ATTCGTATGGCCGGCTGTG -> TTCGTATGGCCGGCTGTGC
AGCCATAGCGGGATAAGAG -> GCCATAGCGGGATAAGAGC
CTTCGTGGAGAACCTCCGT -> TTCGTGGAGAACCTCCGTA
CGGGAATGCTGGGTAAGAC -> GGGAATGCTGGGTAAGACG
CCATCATGCTAATGGCGAC -> CATCATGCTAATGGCGACA
ATGAAGACCATCATGCTAA -> TGAAGACCATCATGCTAAT
ATGTAAAATGCTGGTTTCA -> TGTAAAATGCTGGTTTCAA
TCAATTGCTAGTTCTACAT -> CAATTGCTAGTTCTACATC
TCGTGGAGAACCTCCGTAT -> CGTGGAGAACCTCCGTATC
CGGGAGCCCCCGTCGACAA -> GGGAGCCCCCGTCGACAAA
CCTTATATCTTGTAGCCAC -> CTTATATCTTGTAGCCACG
GATTAGGCTGAACCCACCT -> ATTAGGCTGAACCCACCTC
ATTAAACGCCAATTTGTCA -> TTAAACGCCAATTTGTCAG
CCTCAAACATATTGCTGAG -> CTCAAACATATTGCTGAGG
TCCGCGATTCGTCTGCAAG -> CCGCGATTCGTCTGCAAGA
ACCTGGTTAGCAGAATACT -> CCTGGTTAGCAGAATACTA
GGCTGGCTTCAGACCCTTA -> GCTGGCTTCAGACCCTTAT
CTTACCGGCCTGTCGAGAC -> TTACCGGCCTGTCGAGACT
CAGTCGTCACGTCTGCTAA -> AGTCGTCACGTCTGCTAAA
TCGATGCCGGCCTGTCGAG -> CGATGCCGGCCTGTCGAGA
AAAACGGATCGTACAAACC -> AAACGGATCGTACAAACCG
TCAGACCCTTATCACAAAA -> CAGACCCTTATCACAAAAA
TGTACTTATGGTAGCGGGA -> GTACTTATGGTAGCGGGAA
CCCAGGGCTTGAGATTATA -> CCAGGGCTTGAGATTATAT
TACAGACTAATTAAACGCC -> ACAGACTAATTAAACGCCA
AAGATCTCGTATGTCGTGT -> AGATCTCGTATGTCGTGTC
GGTTTTGCACAATATATGT -> GTTTTGCACAATATATGTT
TTGGCCGTTTCCATGTGGG -> TGGCCGTTTCCATGTGGGC
CAATGAGCCCCGGCCTGTC -> AATGAGCCCCGGCCTGTCG
CCGCGATTCGTCTGCAAGA -> CGCGATTCGTCTGCAAGAC
GAACCTCCGTATCAAGTGT -> AACCTCCGTATCAAGTGTA
TCTTGATTAGGCTGAACCC -> CTTGATTAGGCTGAACCCA
CTCTTGATTAGGCTGAACC -> TCTTGATTAGGCTGAACCC
GGTAAGACGGTAGGATCAC -> GTAAGACGGTAGGATCACA
GCAACAAGGGGTTTTGCAC -> CAACAAGGGGTTTTGCACA
TACAGTCAACTGCGCAACA -> ACAGTCAACTGCGCAACAA
CGCGGGTTATGGTCCTTTA -> GCGGGTTATGGTCCTTTAA
CTAGAGTCGGGCCATGCCT -> TAGAGTCGGGCCATGCCTA
CGGCCTGTCGAGACTCTAA -> GGCCTGTCGAGACTCTAAC
AAATTCGAGCAGAACCCAA -> AATTCGAGCAGAACCCAAA
GTTACCCTAAGATAAGTTT -> TTACCCTAAGATAAGTTTC
TTACCAACTTAGTCCGGAT -> TACCAACTTAGTCCGGATC
AGTAATCTAAAAAGCAATC -> GTAATCTAAAAAGCAATCC
AAATACGAAAGGCACGCTG -> AATACGAAAGGCACGCTGC
AGCCATGTGACACAGGGCG -> GCCATGTGACACAGGGCGT
CGTATGTCGTGTCCATGCT -> GTATGTCGTGTCCATGCTA
TCGACAGTCCGAAATTCAT -> CGACAGTCCGAAATTCATG
GACTCATTACCAACTTAGT -> ACTCATTACCAACTTAGTC
TCTCCTCCTTATATCTTGT -> CTCCTCCTTATATCTTGTA
TAAAGCCCAGCTTTGTTCC -> AAAGCCCAGCTTTGTTCCT
CAAACATATTGCTGAGGCC -> AAACATATTGCTGAGGCCG
CGAGGTATAAACCTTTGCA -> GAGGTATAAACCTTTGCAA
TACCTGGTTAGCAGAATAC -> ACCTGGTTAGCAGAATACT
AAAAAATACACGTCTACGC -> AAAAATACACGTCTACGCG
GTATACAGTTGGTTGCCGA -> TATACAGTTGGTTGCCGAT
TTGTTGTTCCCGAAAGTTA -> TGTTGTTCCCGAAAGTTAC
TCGGGCCATGCCTACTAAG -> CGGGCCATGCCTACTAAGC
CCGGCCATACGGCTCCGAC -> CGGCCATACGGCTCCGACG
GAGCCCCCGTCGACAAACA -> AGCCCCCGTCGACAAACAA
CTGAACCCACCTCCAGGAT -> TGAACCCACCTCCAGGATG
AATTCATGACCCCCCCTCG -> ATTCATGACCCCCCCTCGG
ACGCGACCATGCGTTTCAA -> CGCGACCATGCGTTTCAAC
TAAGATAAGTTTCGAGATC -> AAGATAAGTTTCGAGATCC
AGCCACACCGATCCGTACT -> GCCACACCGATCCGTACTC
GGGAGCCCCCGTCGACAAA -> GGAGCCCCCGTCGACAAAC
TGAGGCCGAATAGCGACCT -> GAGGCCGAATAGCGACCTG
TCACAATAGCGCTGATTGT -> CACAATAGCGCTGATTGTT
CCTTAAATACGACATGTAA -> CTTAAATACGACATGTAAA
CCATGTGGGCGAAGATCTC -> CATGTGGGCGAAGATCTCG
GTTACGCCGTATACGTCGA -> TTACGCCGTATACGTCGAG
CACGTCTGCTAAAGGGCCA -> ACGTCTGCTAAAGGGCCAC
ATGATGGGAGCCCTTATCG -> TGATGGGAGCCCTTATCGA
AATACACGTCTACGCGACC -> ATACACGTCTACGCGACCA
GGTATAAACCTTTGCAAAC -> GTATAAACCTTTGCAAACA
AGACGGTAGGATCACAATT -> GACGGTAGGATCACAATTC
GTCCGCGCATGATGGGAGC -> TCCGCGCATGATGGGAGCC
GCTAAATTCAGCAGCCGTA -> CTAAATTCAGCAGCCGTAG
CCGTCTGTATGCCGGCTGT -> CGTCTGTATGCCGGCTGTT
CTTCGAGTCGATGCCGGCC -> TTCGAGTCGATGCCGGCCT
ATGTGCCAGGCTGTTCTTC -> TGTGCCAGGCTGTTCTTCA
GCTGAACCCACCTCCAGGA -> CTGAACCCACCTCCAGGAT
GGTCGTCAGCTGGTGTCAA -> GTCGTCAGCTGGTGTCAAG
TTCCTTGCGGGAAAATCTA -> TCCTTGCGGGAAAATCTAG
TTCAATTGCTAGTTCTACA -> TCAATTGCTAGTTCTACAT
AGACTCTGCCAGGGAAGTT -> GACTCTGCCAGGGAAGTTT
CATGGGCCTAGAGTCGGGC -> ATGGGCCTAGAGTCGGGCC
ATCTAGAGAACTTTCGAGT -> TCTAGAGAACTTTCGAGTA
TCGAGTGGCTCACCGTAGA -> CGAGTGGCTCACCGTAGAC
TGCCGATTCCGTATCGTCT -> GCCGATTCCGTATCGTCTC
TAGGATCACAATTCCCAGC -> AGGATCACAATTCCCAGCT
ATAAGCCATAGCGGGATAA -> TAAGCCATAGCGGGATAAG
GACCATGCGTTTCAACCGC -> ACCATGCGTTTCAACCGCG
GGAAAATCTAGAGAACTTT -> GAAAATCTAGAGAACTTTC
CACAATTCCCAGCTGCCGG -> ACAATTCCCAGCTGCCGGA
CCAGCTGCCGGAATTTACT -> CAGCTGCCGGAATTTACTC
TTGATCCGCGATTCGTCTG -> TGATCCGCGATTCGTCTGC
TGTGGGTAATTGAGTGAGC -> GTGGGTAATTGAGTGAGCG
GTCGATGCCGGCCTGTCGA -> TCGATGCCGGCCTGTCGAG
GAACCCAAATGTGAGCGCG -> AACCCAAATGTGAGCGCGG
CATCCTGTTACGCCGTATA -> ATCCTGTTACGCCGTATAC
CTACTAAGCCTGGACCGTA -> TACTAAGCCTGGACCGTAG
CAGAAATAATGACAGGTCC -> AGAAATAATGACAGGTCCG
TTCAACCGCGCTGCAGGCA -> TCAACCGCGCTGCAGGCAG
GACTAATAAGCAATCCGCT -> ACTAATAAGCAATCCGCTG
TACTTGATCGGGGATCGGT -> ACTTGATCGGGGATCGGTC
ACAATTCCCAGCTGCCGGA -> CAATTCCCAGCTGCCGGAA
CACGTCTACGCGACCATGC -> ACGTCTACGCGACCATGCG
CCATATCACAACGGCGCAC -> CATATCACAACGGCGCACT
ATACATTAGATGTGGGTAA -> TACATTAGATGTGGGTAAT
TTGATCGGGGATCGGTCGA -> TGATCGGGGATCGGTCGAC
ACTTATGGTAGCGGGAAGT -> CTTATGGTAGCGGGAAGTT
GCACCCGACTCTCGCGCTC -> CACCCGACTCTCGCGCTCT
GAATGCTGGGTAAGACGGT -> AATGCTGGGTAAGACGGTA
AAAATACACGTCTACGCGA -> AAATACACGTCTACGCGAC
TGATGAAGTGCCTTAGTAA -> GATGAAGTGCCTTAGTAAG
CATGCGTTTCAACCGCGCT -> ATGCGTTTCAACCGCGCTG
CCCTTGAACTGTAAGGCCT -> CCTTGAACTGTAAGGCCTT
AATTAAACGCCAATTTGTC -> ATTAAACGCCAATTTGTCA
GGACAGATCCAAGCAATAC -> GACAGATCCAAGCAATACA
GTAGGGGGGGATATCGCTA -> TAGGGGGGGATATCGCTAC
AGGCACGCTGCAAACGCTT -> GGCACGCTGCAAACGCTTT
CACAATATATGTTTGTCCT -> ACAATATATGTTTGTCCTT
CCCCGGCCTGTCGAGACTC -> CCCGGCCTGTCGAGACTCT
AAGGCCTTCGCGGGTTATG -> AGGCCTTCGCGGGTTATGG
ACGACCGATTTTTCCTAGA -> CGACCGATTTTTCCTAGAA
GGACCGTAGCCACACCGAT -> GACCGTAGCCACACCGATC
TAGATGTGGGTAATTGAGT -> AGATGTGGGTAATTGAGTG
CCAGGGAAGTTTTTCCTAG -> CAGGGAAGTTTTTCCTAGA
AAAAATACACGTCTACGCG -> AAAATACACGTCTACGCGA
CTTATATCTTGTAGCCACG -> TTATATCTTGTAGCCACGC
TAGAAAAAAATACGGTTTA -> AGAAAAAAATACGGTTTAA
AAACCGTATGTATAGCTTC -> AACCGTATGTATAGCTTCG
AACGGATCGTACAAACCGT -> ACGGATCGTACAAACCGTA
TCGGTCGACGCCCTTGCTC -> CGGTCGACGCCCTTGCTCC
CTTAGGATGAACTCTGGGT -> TTAGGATGAACTCTGGGTG
ATATGTTTGTCCTTAAATA -> TATGTTTGTCCTTAAATAC
CCCGGTTACCACGCACGAT -> CCGGTTACCACGCACGATG
CACCATATCACAACGGCGC -> ACCATATCACAACGGCGCA
CCGATTCCGTATCGTCTCC -> CGATTCCGTATCGTCTCCT
AAAATTCGAGCAGAACCCA -> AAATTCGAGCAGAACCCAA
TCACAACGGCGCACTTAGG -> CACAACGGCGCACTTAGGA
CCTTCGCGGGTTATGGTCC -> CTTCGCGGGTTATGGTCCT
CGACATGTAAAATGCTGGT -> GACATGTAAAATGCTGGTT
CCTGAGCTACACGACCCCT -> CTGAGCTACACGACCCCTG
ATGGGCCTAGAGTCGGGCC -> TGGGCCTAGAGTCGGGCCA
AGAGTCGGGCCATGCCTAC -> GAGTCGGGCCATGCCTACT
GTTGGCTCTTGATTAGGCT -> TTGGCTCTTGATTAGGCTG
TTTGTCCTTAAATACGACA -> TTGTCCTTAAATACGACAT
TGCGTTTCAACCGCGCTGC -> GCGTTTCAACCGCGCTGCA
ATGCTAAGACTAATAAGCA -> TGCTAAGACTAATAAGCAA
CGACCGATTTTTCCTAGAA -> GACCGATTTTTCCTAGAAA
CAATACATTAGATGTGGGT -> AATACATTAGATGTGGGTA
GACTCTCGCGCTCTACAGT -> ACTCTCGCGCTCTACAGTC
ATGCTGGTTTCAATTGCTA -> TGCTGGTTTCAATTGCTAG
CGCCGTATACGTCGAGATG -> GCCGTATACGTCGAGATGG
TATGTGGGCCGCCTCCCAG -> ATGTGGGCCGCCTCCCAGG
TAGACTCGTGACACGGTGT -> AGACTCGTGACACGGTGTA
TGCCGGCTGTTGTTGTTCC -> GCCGGCTGTTGTTGTTCCC
CGCCAAGAAATCTGCCTCC -> GCCAAGAAATCTGCCTCCT
GACATATCGTAAATTCGGC -> ACATATCGTAAATTCGGCT
AGAAAAGAAGGGTATTGCT -> GAAAAGAAGGGTATTGCTT
CAATAATGAAGACCATCAT -> AATAATGAAGACCATCATG
GCAGCTTGAACTTTGCCGG -> CAGCTTGAACTTTGCCGGG
CCTACCGTGTTTCATGAAT -> CTACCGTGTTTCATGAATC
CTAAGACTAATAAGCAATC -> TAAGACTAATAAGCAATCC
ACCATATCACAACGGCGCA -> CCATATCACAACGGCGCAC
CATGCTAATGGCGACACCC -> ATGCTAATGGCGACACCCT
CACGCTGCAAACGCTTTGA -> ACGCTGCAAACGCTTTGAT
AGGCGTGTTGGCTCTTGAT -> GGCGTGTTGGCTCTTGATT
GAAATTCATGACCCCCCCT -> AAATTCATGACCCCCCCTC
AAGCCATAGCGGGATAAGA -> AGCCATAGCGGGATAAGAG
TACGCCGTATACGTCGAGA -> ACGCCGTATACGTCGAGAT
CCTTGCGGGAAAATCTAGA -> CTTGCGGGAAAATCTAGAG
AAATCAGCATGCTCAGCTA -> AATCAGCATGCTCAGCTAA
GTCGGACTATAGCATCACA -> TCGGACTATAGCATCACAA
GAAAGTTACCCTAAGATAA -> AAAGTTACCCTAAGATAAG
TCCGGCCTGTCGAGACTCT -> CCGGCCTGTCGAGACTCTT
CGTCGAGATGGCCCGGTTA -> GTCGAGATGGCCCGGTTAC
TTTCCATGTGGGCGAAGAT -> TTCCATGTGGGCGAAGATC
ATAGCGGGATAAGAGCACC -> TAGCGGGATAAGAGCACCC
ATATTGCTGAGGCCGAATA -> TATTGCTGAGGCCGAATAG
TGAAGACCATCATGCTAAT -> GAAGACCATCATGCTAATG
GACGCCCCGTCTGTATGCC -> ACGCCCCGTCTGTATGCCG
AAAGAAGGGTATTGCTTAT -> AAGAAGGGTATTGCTTATG
TTCATGACCCCCCCTCGGG -> TCATGACCCCCCCTCGGGC
TCCAGGATGTCATATTCGT -> CCAGGATGTCATATTCGTA
ACACGGTGTACAATGAGCC -> CACGGTGTACAATGAGCCC
TTCATGAATCAACAAATCA -> TCATGAATCAACAAATCAG
AACCCAGTAATCTAAAAAG -> ACCCAGTAATCTAAAAAGC
TCCTTGCGGGAAAATCTAG -> CCTTGCGGGAAAATCTAGA
AGGCACCCGGCCGCCAAGA -> GGCACCCGGCCGCCAAGAA
CCAGGATGTCATATTCGTA -> CAGGATGTCATATTCGTAT
GCTTCGAGTCGATGCCGGC -> CTTCGAGTCGATGCCGGCC
GATCACAATTCCCAGCTGC -> ATCACAATTCCCAGCTGCC
GATGGGAGCCCTTATCGAG -> ATGGGAGCCCTTATCGAGT
GCTAATAATAATAAGCCAT -> CTAATAATAATAAGCCATA
ATCGAGTGGCTCACCGTAG -> TCGAGTGGCTCACCGTAGA
TTTGATCCGCGATTCGTCT -> TTGATCCGCGATTCGTCTG
AGGGGTACTCGATTAAAGG -> GGGGTACTCGATTAAAGGT
CTACTAGTCGGACTATAGC -> TACTAGTCGGACTATAGCA
GTCGTTTTCCTAGAAAAAA -> TCGTTTTCCTAGAAAAAAA
AGACATGACGACTCATTAC -> GACATGACGACTCATTACC
TGGGAGCCCTTATCGAGTG -> GGGAGCCCTTATCGAGTGG
GGTCACCTTATTGATCTTC -> GTCACCTTATTGATCTTCG
TGAGATTATATTGGTGATG -> GAGATTATATTGGTGATGT
AAGTTTCGAGATCCCTTAC -> AGTTTCGAGATCCCTTACA
ATGTCGTGTCCATGCTAAT -> TGTCGTGTCCATGCTAATA
GGCTCCGACGGGCAGAGAA -> GCTCCGACGGGCAGAGAAG
ATACGGTTTAAAGCCCAGC -> TACGGTTTAAAGCCCAGCT
CTAAATTCAGCAGCCGTAG -> TAAATTCAGCAGCCGTAGG
AGGGCGTCTTGGCCGTTTC -> GGGCGTCTTGGCCGTTTCC
GACGTCACCGTCCATGGGC -> ACGTCACCGTCCATGGGCC
CCCCCCCTCGGGCGCTTCG -> CCCCCCTCGGGCGCTTCGT
ACTCGTGACACGGTGTACA -> CTCGTGACACGGTGTACAA
AGTCCGCGCATGATGGGAG -> GTCCGCGCATGATGGGAGC
CAGATCCAAGCAATACATT -> AGATCCAAGCAATACATTA
AGCTTGAACTTTGCCGGGA -> GCTTGAACTTTGCCGGGAG
TATGGCCGGCTGTGCGTGG -> ATGGCCGGCTGTGCGTGGA
TCATGAATCAACAAATCAG -> CATGAATCAACAAATCAGC
ACTCTCCACGACCGATTTT -> CTCTCCACGACCGATTTTT
ATGACGACTCATTACCAAC -> TGACGACTCATTACCAACT
ACGTCTGCTAAAGGGCCAC -> CGTCTGCTAAAGGGCCACC
AAAAATACGGTTTAAAGCC -> AAAATACGGTTTAAAGCCC
ACGCCCCGTCTGTATGCCG -> CGCCCCGTCTGTATGCCGG
ACCCGGCCGCCAAGAAATC -> CCCGGCCGCCAAGAAATCT
TCACGTCTGCTAAAGGGCC -> CACGTCTGCTAAAGGGCCA
TTGAGTGAGCGTAACAGGT -> TGAGTGAGCGTAACAGGTC
GATCCAAGCAATACATTAG -> ATCCAAGCAATACATTAGA
CTGTTCTTCACCATATCAC -> TGTTCTTCACCATATCACA
CTAAAACCAGATTCGACAG -> TAAAACCAGATTCGACAGT
TAGCGGGAAGTTCGCCTGT -> AGCGGGAAGTTCGCCTGTA
TCAAATGACGTCACCGTCC -> CAAATGACGTCACCGTCCA
GCTGGGTAAGACGGTAGGA -> CTGGGTAAGACGGTAGGAT
CTGTGCGTGGACAGATCCA -> TGTGCGTGGACAGATCCAA
CGAGTCGATGCCGGCCTGT -> GAGTCGATGCCGGCCTGTC
GACACAGGGCGTCTTGGCC -> ACACAGGGCGTCTTGGCCG
TGTGCAGTCGTCACGTCTG -> GTGCAGTCGTCACGTCTGC
TTCCTAGAAAAAAATACAC -> TCCTAGAAAAAAATACACG
GATTATATTGGTGATGTGC -> ATTATATTGGTGATGTGCC
GAATTTACTCTATAAAAGA -> AATTTACTCTATAAAAGAA
TATATTGGTGATGTGCCAG -> ATATTGGTGATGTGCCAGG
GACTCTCCACGACCGATTT -> ACTCTCCACGACCGATTTT
CTAGAAAAAAATACGGTTT -> TAGAAAAAAATACGGTTTA
AGCTTCGAGTCGATGCCGG -> GCTTCGAGTCGATGCCGGC
GTTTCATGAATCAACAAAT -> TTTCATGAATCAACAAATC
GACTCTGCCAGGGAAGTTT -> ACTCTGCCAGGGAAGTTTT
GACTATAGCATCACAATAG -> ACTATAGCATCACAATAGC
GTGGGCCGCCTCCCAGGGC -> TGGGCCGCCTCCCAGGGCT
GTACGCTAAAACCAGATTC -> TACGCTAAAACCAGATTCG
AGAATACTATGTGGGCCGC -> GAATACTATGTGGGCCGCC
TCAGGCCTGAGCTACACGA -> CAGGCCTGAGCTACACGAC
ATTGCTAGTTCTACATCCT -> TTGCTAGTTCTACATCCTG
ACGACCCCTGGGGCTTCTA -> CGACCCCTGGGGCTTCTAG
CCCAGTAATCTAAAAAGCA -> CCAGTAATCTAAAAAGCAA
CCTAGAAAAAAATACGAAA -> CTAGAAAAAAATACGAAAG
AGGATGAACTCTGGGTGAG -> GGATGAACTCTGGGTGAGG
TTCGAGTAATAGAGGTCGT -> TCGAGTAATAGAGGTCGTC
TGACGACTCATTACCAACT -> GACGACTCATTACCAACTT
TTCGCCTGTACATGTGCAG -> TCGCCTGTACATGTGCAGT
TTAGTCCGGATCGTCTCTC -> TAGTCCGGATCGTCTCTCA
GGGCTTGAGATTATATTGG -> GGCTTGAGATTATATTGGT
GAAGATCTCGTATGTCGTG -> AAGATCTCGTATGTCGTGT
ACCGTAGCCACACCGATCC -> CCGTAGCCACACCGATCCG
CGATGCCGGCCTGTCGAGA -> GATGCCGGCCTGTCGAGAC
ACATTAGATGTGGGTAATT -> CATTAGATGTGGGTAATTG
AATCTGCCTCCTACCGTGT -> ATCTGCCTCCTACCGTGTT
AACCAGATTCGACAGTCCG -> ACCAGATTCGACAGTCCGA
ATATAATTAGGGGTCAAAC -> TATAATTAGGGGTCAAACC
ATCGGGGATCGGTCGACGC -> TCGGGGATCGGTCGACGCC
GTCATATTCGTATGGCCGG -> TCATATTCGTATGGCCGGC
TGGTTAGCAGAATACTATG -> GGTTAGCAGAATACTATGT
GCCACACCGATCCGTACTC -> CCACACCGATCCGTACTCT
TTGGCTCTTGATTAGGCTG -> TGGCTCTTGATTAGGCTGA
TGCGCAACAAGGGGTTTTG -> GCGCAACAAGGGGTTTTGC
AGCAATCCGCTGATGAAGT -> GCAATCCGCTGATGAAGTG
AAAATACGGTTTAAAGCCC -> AAATACGGTTTAAAGCCCA
CCCGGCCTGTCGAGACTCT -> CCGGCCTGTCGAGACTCTC
CTCTATAAAAGAAGTGCAG -> TCTATAAAAGAAGTGCAGG
CTTCAGACCCTTATCACAA -> TTCAGACCCTTATCACAAA
CACCGTCCATGGGCCTAGA -> ACCGTCCATGGGCCTAGAG
GCCAATTTGTCAGGCCTGA -> CCAATTTGTCAGGCCTGAG
TGCAGTCGTCACGTCTGCT -> GCAGTCGTCACGTCTGCTA
GAGATTATATTGGTGATGT -> AGATTATATTGGTGATGTG
AATCAACAAATCAGCATGC -> ATCAACAAATCAGCATGCT
TCTGGGTGAGGCGTGTTGG -> CTGGGTGAGGCGTGTTGGC
AACTGTAAGGCCTTCGCGG -> ACTGTAAGGCCTTCGCGGG
ACTTTGCCGGGAGCCCCCG -> CTTTGCCGGGAGCCCCCGT
CGTATACGTCGAGATGGCC -> GTATACGTCGAGATGGCCC
GTGACACGGTGTACAATGA -> TGACACGGTGTACAATGAG
TGGCTGGCTTCAGACCCTT -> GGCTGGCTTCAGACCCTTA
TCGTCACGTCTGCTAAAGG -> CGTCACGTCTGCTAAAGGG
CGTTTTCCTAGAAAAAAAT -> GTTTTCCTAGAAAAAAATA,GTTTTCCTAGAAAAAAATA
GGCCTGAGCTACACGACCC -> GCCTGAGCTACACGACCCC
ATGGTTCGTTTTCCTAGAA -> TGGTTCGTTTTCCTAGAAA
AAGGGGTTTTGCACAATAT -> AGGGGTTTTGCACAATATA
ACTCTGGGTGAGGCGTGTT -> CTCTGGGTGAGGCGTGTTG
GGGCCGCCTCCCAGGGCTT -> GGCCGCCTCCCAGGGCTTG
AGCGCTGATTGTTGCTTAC -> GCGCTGATTGTTGCTTACC
AGTCGGACTATAGCATCAC -> GTCGGACTATAGCATCACA
AGAGGTCGTCAGCTGGTGT -> GAGGTCGTCAGCTGGTGTC
GAACTTTCGAGTAATAGAG -> AACTTTCGAGTAATAGAGG
TATGTATAGCTTCGAGTCG -> ATGTATAGCTTCGAGTCGA
CAGGGCGTCTTGGCCGTTT -> AGGGCGTCTTGGCCGTTTC
TGCCAGGGAAGTTTTTCCT -> GCCAGGGAAGTTTTTCCTA
CCTTAGTAAGAGGCACCCG -> CTTAGTAAGAGGCACCCGG
TTAAAAGTACGCTAAAACC -> TAAAAGTACGCTAAAACCA
AAGAGCACCCGACTCTCGC -> AGAGCACCCGACTCTCGCG
GCGACCATGCGTTTCAACC -> CGACCATGCGTTTCAACCG
GCCACGCTTCCTATACCTG -> CCACGCTTCCTATACCTGG
GGATGTCATATTCGTATGG -> GATGTCATATTCGTATGGC
TCCTACCGTGTTTCATGAA -> CCTACCGTGTTTCATGAAT
CGACGGGCAGAGAAGCTTT -> GACGGGCAGAGAAGCTTTG
AGATCCAAGCAATACATTA -> GATCCAAGCAATACATTAG
CTGAGGCCGAATAGCGACC -> TGAGGCCGAATAGCGACCT
AGAAGGGTATTGCTTATGC -> GAAGGGTATTGCTTATGCG
AAAAAATACGAAAGGCACG -> AAAAATACGAAAGGCACGC
AATACATTAGATGTGGGTA -> ATACATTAGATGTGGGTAA
GCAGAACCCAAATGTGAGC -> CAGAACCCAAATGTGAGCG
GTATAGCTTCGAGTCGATG -> TATAGCTTCGAGTCGATGC
CAGGATGTCATATTCGTAT -> AGGATGTCATATTCGTATG
ATGAAGTGCCTTAGTAAGA -> TGAAGTGCCTTAGTAAGAG
ACCCCTCAAACATATTGCT -> CCCCTCAAACATATTGCTG
TCCGTACTCTTACAGACTA -> CCGTACTCTTACAGACTAA
ATCATGCTAATGGCGACAC -> TCATGCTAATGGCGACACC
TGCTCAGCTAAAACGGATC -> GCTCAGCTAAAACGGATCG
TCCCGGCCATACGGCTCCG -> CCCGGCCATACGGCTCCGA
ATCCAAGCAATACATTAGA -> TCCAAGCAATACATTAGAT
ACCCAAATGTGAGCGCGGA -> CCCAAATGTGAGCGCGGAG
CTTAGTAAGAGGCACCCGG -> TTAGTAAGAGGCACCCGGC
TAATCTAAAAAGCAATCCC -> AATCTAAAAAGCAATCCCT
TAAAACCAGATTCGACAGT -> AAAACCAGATTCGACAGTC
GATGAACTCTGGGTGAGGC -> ATGAACTCTGGGTGAGGCG
TGTCAAGGCAGCTTGAACT -> GTCAAGGCAGCTTGAACTT
AAGGGCCACCAAAATGGCT -> AGGGCCACCAAAATGGCTG
ACCTGTATACAGTTGGTTG -> CCTGTATACAGTTGGTTGC
CTATACCTGGTTAGCAGAA -> TATACCTGGTTAGCAGAAT
GAAGACCATCATGCTAATG -> AAGACCATCATGCTAATGG
ATAAAAGAAGTGCAGGGTA -> TAAAAGAAGTGCAGGGTAA
GTACATGTGCAGTCGTCAC -> TACATGTGCAGTCGTCACG
CGATTTTTCCTAGAAAAAA -> GATTTTTCCTAGAAAAAAA
GGCCTAGAGTCGGGCCATG -> GCCTAGAGTCGGGCCATGC
TCCTATACCTGGTTAGCAG -> CCTATACCTGGTTAGCAGA
AATGAAGACCATCATGCTA -> ATGAAGACCATCATGCTAA
GAAAATCTAGAGAACTTTC -> AAAATCTAGAGAACTTTCG
TACTAGTCGGACTATAGCA -> ACTAGTCGGACTATAGCAT
TCTACATCCTGTTACGCCG -> CTACATCCTGTTACGCCGT
GAGCGCGGAGCCATGTGAC -> AGCGCGGAGCCATGTGACA
AAAAATACCCAGAAATAAT -> AAAATACCCAGAAATAATG
CCAGCTTTGTTCCTTGCGG -> CAGCTTTGTTCCTTGCGGG
ACCCAGTAATCTAAAAAGC -> CCCAGTAATCTAAAAAGCA
CGGGATAAGAGCACCCGAC -> GGGATAAGAGCACCCGACT
CCTTGCTCCCGGCCATACG -> CTTGCTCCCGGCCATACGG
CATATCACAACGGCGCACT -> ATATCACAACGGCGCACTT
GGCTCACCGTAGACTCGTG -> GCTCACCGTAGACTCGTGA
GTTGGTTGCCGATTCCGTA -> TTGGTTGCCGATTCCGTAT
CCTGTCGAGACTCTGCCAG -> CTGTCGAGACTCTGCCAGG
CGGCTCCGACGGGCAGAGA -> GGCTCCGACGGGCAGAGAA
GGAAGTTCGCCTGTACATG -> GAAGTTCGCCTGTACATGT
AGGCAGGGGTACTCGATTA -> GGCAGGGGTACTCGATTAA
AAGTGCAGGGTAAAGAAAA -> AGTGCAGGGTAAAGAAAAG
TTTAAATCTCAGACCCCTC -> TTAAATCTCAGACCCCTCA
CCGGCCTGTCGAGACTCTA -> CGGCCTGTCGAGACTCTAA
TGCAGGGTAAAGAAAAGAA -> GCAGGGTAAAGAAAAGAAG
GCGTCTTGGCCGTTTCCAT -> CGTCTTGGCCGTTTCCATG
TCCGCGCATGATGGGAGCC -> CCGCGCATGATGGGAGCCC
CAAACGCTTTGATCCGCGA -> AAACGCTTTGATCCGCGAT
AGAACCTCCGTATCAAGTG -> GAACCTCCGTATCAAGTGT
TTCTACATCCTGTTACGCC -> TCTACATCCTGTTACGCCG
TGTAAGGCCTTCGCGGGTT -> GTAAGGCCTTCGCGGGTTA
CACGCACGATGCGGGAATG -> ACGCACGATGCGGGAATGC
AAGGTCACTGAATGTTAAA -> AGGTCACTGAATGTTAAAA
TTAAATCTCAGACCCCTCA -> TAAATCTCAGACCCCTCAA
CCGAAATTCATGACCCCCC -> CGAAATTCATGACCCCCCC
AGGGGGGGATATCGCTACA -> GGGGGGGATATCGCTACAC
CAAATGACGTCACCGTCCA -> AAATGACGTCACCGTCCAT
GTCTTGGCCGTTTCCATGT -> TCTTGGCCGTTTCCATGTG
GCAGAGAAGCTTTGCCGAC -> CAGAGAAGCTTTGCCGACG
AGTGCCTTAGTAAGAGGCA -> GTGCCTTAGTAAGAGGCAC
AGGGCCACCAAAATGGCTG -> GGGCCACCAAAATGGCTGG
TTAAAGCCCAGCTTTGTTC -> TAAAGCCCAGCTTTGTTCC
GTAAAGAAAAGAAGGGTAT -> TAAAGAAAAGAAGGGTATT
AATTCCCAGCTGCCGGAAT -> ATTCCCAGCTGCCGGAATT
GTACTTATGGTAGCGGGAA -> TACTTATGGTAGCGGGAAG
CAATCCGCTGATGAAGTGC -> AATCCGCTGATGAAGTGCC
AAATTCGGCTCCTATGCTA -> AATTCGGCTCCTATGCTAA
TCCATGTGGGCGAAGATCT -> CCATGTGGGCGAAGATCTC
AGGGAAGTTTTTCCTAGAA -> GGGAAGTTTTTCCTAGAAA
GTCACTGAATGTTAAAAGT -> TCACTGAATGTTAAAAGTA
GGGATATCGCTACACGTTA -> GGATATCGCTACACGTTAC
TAAAGAAAAGAAGGGTATT -> AAAGAAAAGAAGGGTATTG
AGTCCGGATCGTCTCTCAG -> GTCCGGATCGTCTCTCAGT
CCTCCCAGGGCTTGAGATT -> CTCCCAGGGCTTGAGATTA
CTGTTGTTGTTCCCGAAAG -> TGTTGTTGTTCCCGAAAGT
ATACGGCTCCGACGGGCAG -> TACGGCTCCGACGGGCAGA
CTAGTCGGACTATAGCATC -> TAGTCGGACTATAGCATCA
AATCTAGAGAACTTTCGAG -> ATCTAGAGAACTTTCGAGT
CAAGGGGTTTTGCACAATA -> AAGGGGTTTTGCACAATAT
TCGTGTCCATGCTAATAAT -> CGTGTCCATGCTAATAATA
ATCGCTACACGTTACTTGA -> TCGCTACACGTTACTTGAT
AGGGTATTGCTTATGCGAG -> GGGTATTGCTTATGCGAGG
ATAAACCTTTGCAAACAGG -> TAAACCTTTGCAAACAGGC
GCCGAATAGCGACCTGTAT -> CCGAATAGCGACCTGTATA
AAATGCTGGTTTCAATTGC -> AATGCTGGTTTCAATTGCT
CTCAGTCATTATCCGACAT -> TCAGTCATTATCCGACATA
GTTCGTTTTCCTAGAAAAA -> TTCGTTTTCCTAGAAAAAA
AACAAGCCACTCAATAATG -> ACAAGCCACTCAATAATGA
TTTGTTCCTTGCGGGAAAA -> TTGTTCCTTGCGGGAAAAT
ACGCCGTATACGTCGAGAT -> CGCCGTATACGTCGAGATG
TGAATGTTAAAAGTACGCT -> GAATGTTAAAAGTACGCTA
CCACCTCCAGGATGTCATA -> CACCTCCAGGATGTCATAT
GACCCTTATCACAAAAATT -> ACCCTTATCACAAAAATTC
GGTCGACGCCCTTGCTCCC -> GTCGACGCCCTTGCTCCCG
GGAGCCCCCGTCGACAAAC -> GAGCCCCCGTCGACAAACA
CCACGCTTCCTATACCTGG -> CACGCTTCCTATACCTGGT
GTTCAAATGACGTCACCGT -> TTCAAATGACGTCACCGTC
CCGTAGACTCGTGACACGG -> CGTAGACTCGTGACACGGT
ATGCGAGGTATAAACCTTT -> TGCGAGGTATAAACCTTTG
ACTCTTACAGACTAATTAA -> CTCTTACAGACTAATTAAA
GTGGAGAACCTCCGTATCA -> TGGAGAACCTCCGTATCAA
ATTGTTCAAATGACGTCAC -> TTGTTCAAATGACGTCACC
AAGACCATCATGCTAATGG -> AGACCATCATGCTAATGGC
AACATGGTTCGTTTTCCTA -> ACATGGTTCGTTTTCCTAG
CTTAAATACGACATGTAAA -> TTAAATACGACATGTAAAA
CTATAGCATCACAATAGCG -> TATAGCATCACAATAGCGC
GCGATTCGTCTGCAAGACA -> CGATTCGTCTGCAAGACAT
CCGATTTTTCCTAGAAAAA -> CGATTTTTCCTAGAAAAAA
AGCCCAGCTTTGTTCCTTG -> GCCCAGCTTTGTTCCTTGC
ACGTTACTTGATCGGGGAT -> CGTTACTTGATCGGGGATC
CCCTCAAACATATTGCTGA -> CCTCAAACATATTGCTGAG
ATCTTCGCCCACTGCTAAA -> TCTTCGCCCACTGCTAAAT
ATAATGAAGACCATCATGC -> TAATGAAGACCATCATGCT
TGTTGTTGTTCCCGAAAGT -> GTTGTTGTTCCCGAAAGTT
ATCCCTTACATTGTTCAAA -> TCCCTTACATTGTTCAAAT
CTACATCCTGTTACGCCGT -> TACATCCTGTTACGCCGTA
TTTGCCGACGCCCCGTCTG -> TTGCCGACGCCCCGTCTGT
ACCTCCGTATCAAGTGTAC -> CCTCCGTATCAAGTGTACT
CTGCAAGACATGACGACTC -> TGCAAGACATGACGACTCA
AGGCAGCTTGAACTTTGCC -> GGCAGCTTGAACTTTGCCG
TGCTAGTTCTACATCCTGT -> GCTAGTTCTACATCCTGTT
AAAGAAAAGAAGGGTATTG -> AAGAAAAGAAGGGTATTGC
CCCACTGCTAAATTCAGCA -> CCACTGCTAAATTCAGCAG
GCCTGTACATGTGCAGTCG -> CCTGTACATGTGCAGTCGT
CAGGCCTGAGCTACACGAC -> AGGCCTGAGCTACACGACC
GTCGTCAGCTGGTGTCAAG -> TCGTCAGCTGGTGTCAAGG
AAATCTCAGACCCCTCAAA -> AATCTCAGACCCCTCAAAC
ATACAGTTGGTTGCCGATT -> TACAGTTGGTTGCCGATTC
CCGACGGGCAGAGAAGCTT -> CGACGGGCAGAGAAGCTTT
AAAAAAATACGAAAGGCAC -> AAAAAATACGAAAGGCACG
GAGACTCTAACATGGTTCG -> AGACTCTAACATGGTTCGT
GACATGACGACTCATTACC -> ACATGACGACTCATTACCA
ACATGTGCAGTCGTCACGT -> CATGTGCAGTCGTCACGTC
TCGTCAGCTGGTGTCAAGG -> CGTCAGCTGGTGTCAAGGC
CTATAAAAGAAGTGCAGGG -> TATAAAAGAAGTGCAGGGT
AGAGCACCCGACTCTCGCG -> GAGCACCCGACTCTCGCGC
ACGAAAGGCACGCTGCAAA -> CGAAAGGCACGCTGCAAAC
TATCGCTACACGTTACTTG -> ATCGCTACACGTTACTTGA
TATCGTCTCCTCCTTATAT -> ATCGTCTCCTCCTTATATC
CACACCGATCCGTACTCTT -> ACACCGATCCGTACTCTTA
CTAATAATAATAAGCCATA -> TAATAATAATAAGCCATAG
AAAAATTCGAGCAGAACCC -> AAAATTCGAGCAGAACCCA
TATCGTAAATTCGGCTCCT -> ATCGTAAATTCGGCTCCTA
TCTCAGACCCCTCAAACAT -> CTCAGACCCCTCAAACATA
AACGCTTTGATCCGCGATT -> ACGCTTTGATCCGCGATTC
CTGGGGCTTCTAGTCCGCG -> TGGGGCTTCTAGTCCGCGC
GGATCGTACAAACCGTATG -> GATCGTACAAACCGTATGT
TGCTTATGCGAGGTATAAA -> GCTTATGCGAGGTATAAAC
AAGGCAGCTTGAACTTTGC -> AGGCAGCTTGAACTTTGCC
ATTCAGCAGCCGTAGGGGG -> TTCAGCAGCCGTAGGGGGG
CCTGGTTAGCAGAATACTA -> CTGGTTAGCAGAATACTAT
AGTCAACTGCGCAACAAGG -> GTCAACTGCGCAACAAGGG
GTTCCTTGCGGGAAAATCT -> TTCCTTGCGGGAAAATCTA
AGATCTCGTATGTCGTGTC -> GATCTCGTATGTCGTGTCC
CACTGCTAAATTCAGCAGC -> ACTGCTAAATTCAGCAGCC
AAATGACGTCACCGTCCAT -> AATGACGTCACCGTCCATG
CTGGTTAGCAGAATACTAT -> TGGTTAGCAGAATACTATG
GGCGCTTCGTGGAGAACCT -> GCGCTTCGTGGAGAACCTC
CCTAGAAAAAAATACACGT -> CTAGAAAAAAATACACGTC
ATGTGGGCGAAGATCTCGT -> TGTGGGCGAAGATCTCGTA
CGCTTCCTATACCTGGTTA -> GCTTCCTATACCTGGTTAG
AGCAGAATACTATGTGGGC -> GCAGAATACTATGTGGGCC
TTGCTTACCGGCCTGTCGA -> TGCTTACCGGCCTGTCGAG
CTGGGTAAGACGGTAGGAT -> TGGGTAAGACGGTAGGATC
TGACGTCACCGTCCATGGG -> GACGTCACCGTCCATGGGC
AAATATAATTAGGGGTCAA -> AATATAATTAGGGGTCAAA
CGTCTGCTAAAGGGCCACC -> GTCTGCTAAAGGGCCACCA
TGCCGGAATTTACTCTATA -> GCCGGAATTTACTCTATAA
TAAGGCCTTCGCGGGTTAT -> AAGGCCTTCGCGGGTTATG
TATACCTGGTTAGCAGAAT -> ATACCTGGTTAGCAGAATA
ACCCACCTCCAGGATGTCA -> CCCACCTCCAGGATGTCAT
CCTTATTGATCTTCGCCCA -> CTTATTGATCTTCGCCCAC
GTTGCTTACCGGCCTGTCG -> TTGCTTACCGGCCTGTCGA
CTCGTATGTCGTGTCCATG -> TCGTATGTCGTGTCCATGC
GAAATCTGCCTCCTACCGT -> AAATCTGCCTCCTACCGTG
GGCCTGTCGAGACTCTAAC -> GCCTGTCGAGACTCTAACA
CAGCTAAAACGGATCGTAC -> AGCTAAAACGGATCGTACA
GATGTGGGTAATTGAGTGA -> ATGTGGGTAATTGAGTGAG
AGATCCCTTACATTGTTCA -> GATCCCTTACATTGTTCAA
CATATTGCTGAGGCCGAAT -> ATATTGCTGAGGCCGAATA
GCCGGCTGTTGTTGTTCCC -> CCGGCTGTTGTTGTTCCCG
AAGCAATACATTAGATGTG -> AGCAATACATTAGATGTGG
GGCCACCAAAATGGCTGGC -> GCCACCAAAATGGCTGGCT
TACCACGCACGATGCGGGA -> ACCACGCACGATGCGGGAA
GCTGTGCGTGGACAGATCC -> CTGTGCGTGGACAGATCCA
TTGTTCCTTGCGGGAAAAT -> TGTTCCTTGCGGGAAAATC
AGCGGGATAAGAGCACCCG -> GCGGGATAAGAGCACCCGA
CCGTATGTATAGCTTCGAG -> CGTATGTATAGCTTCGAGT
AGATTATATTGGTGATGTG -> GATTATATTGGTGATGTGC
CTCCAGGATGTCATATTCG -> TCCAGGATGTCATATTCGT
CTTTGCCGACGCCCCGTCT -> TTTGCCGACGCCCCGTCTG
GAGCTACACGACCCCTGGG -> AGCTACACGACCCCTGGGG
ATGGTCCTTTAAATCTCAG -> TGGTCCTTTAAATCTCAGA
GCCATGTGACACAGGGCGT -> CCATGTGACACAGGGCGTC
AACATATTGCTGAGGCCGA -> ACATATTGCTGAGGCCGAA
TCAACCGCGCTGCAGGCAG -> CAACCGCGCTGCAGGCAGG
AATAAGCCATAGCGGGATA -> ATAAGCCATAGCGGGATAA
ACATATCGTAAATTCGGCT -> CATATCGTAAATTCGGCTC
CGAGACTCTAACATGGTTC -> GAGACTCTAACATGGTTCG
TGTTTCATGAATCAACAAA -> GTTTCATGAATCAACAAAT
GGCTGTTGTTGTTCCCGAA -> GCTGTTGTTGTTCCCGAAA
GCCGACGCCCCGTCTGTAT -> CCGACGCCCCGTCTGTATG
ATACCTGGTTAGCAGAATA -> TACCTGGTTAGCAGAATAC
GTAGCCACACCGATCCGTA -> TAGCCACACCGATCCGTAC
TGTACATGTGCAGTCGTCA -> GTACATGTGCAGTCGTCAC
AAGAAAAGAAGGGTATTGC -> AGAAAAGAAGGGTATTGCT
GGGGGGGATATCGCTACAC -> GGGGGGATATCGCTACACG
GGCCGGCTGTGCGTGGACA -> GCCGGCTGTGCGTGGACAG
GCGACACCCTACTAGTCGG -> CGACACCCTACTAGTCGGA
AAAATCTAGAGAACTTTCG -> AAATCTAGAGAACTTTCGA
TCGTACAAACCGTATGTAT -> CGTACAAACCGTATGTATA
ACCATCATGCTAATGGCGA -> CCATCATGCTAATGGCGAC
GTACAATGAGCCCCGGCCT -> TACAATGAGCCCCGGCCTG
GCCTGAGCTACACGACCCC -> CCTGAGCTACACGACCCCT
TTCGAGTCGATGCCGGCCT -> TCGAGTCGATGCCGGCCTG
GGTACTCGATTAAAGGTCA -> GTACTCGATTAAAGGTCAC
AGTGGCTCACCGTAGACTC -> GTGGCTCACCGTAGACTCG
GACAGGTCCGGCCTGTCGA -> ACAGGTCCGGCCTGTCGAG
TGTATGCCGGCTGTTGTTG -> GTATGCCGGCTGTTGTTGT
TGTTCCTTGCGGGAAAATC -> GTTCCTTGCGGGAAAATCT
TGCTAAAGGGCCACCAAAA -> GCTAAAGGGCCACCAAAAT
CGAGTAATAGAGGTCGTCA -> GAGTAATAGAGGTCGTCAG
GAACTGTAAGGCCTTCGCG -> AACTGTAAGGCCTTCGCGG
GGATCGGTCGACGCCCTTG -> GATCGGTCGACGCCCTTGC
AGCCGTAGGGGGGGATATC -> GCCGTAGGGGGGGATATCG
TACCCAGAAATAATGACAG -> ACCCAGAAATAATGACAGG
TATAATTAGGGGTCAAACC -> ATAATTAGGGGTCAAACCC
AATACGGTTTAAAGCCCAG -> ATACGGTTTAAAGCCCAGC
CTAAAGGGCCACCAAAATG -> TAAAGGGCCACCAAAATGG
GGGTAATTGAGTGAGCGTA -> GGTAATTGAGTGAGCGTAA
GTCGGGCCATGCCTACTAA -> TCGGGCCATGCCTACTAAG
TTTGCCGGGAGCCCCCGTC -> TTGCCGGGAGCCCCCGTCG
ATTACCAACTTAGTCCGGA -> TTACCAACTTAGTCCGGAT
AGCGTAACAGGTCACCTTA -> GCGTAACAGGTCACCTTAT
AGTGAGCGTAACAGGTCAC -> GTGAGCGTAACAGGTCACC
AGACTAATAAGCAATCCGC -> GACTAATAAGCAATCCGCT
GATGAAGTGCCTTAGTAAG -> ATGAAGTGCCTTAGTAAGA
TTCGTATGGCCGGCTGTGC -> TCGTATGGCCGGCTGTGCG
GAGAACTTTCGAGTAATAG -> AGAACTTTCGAGTAATAGA
TGAACTTTGCCGGGAGCCC -> GAACTTTGCCGGGAGCCCC
GTGGCTCACCGTAGACTCG -> TGGCTCACCGTAGACTCGT
GCTTCGTGGAGAACCTCCG -> CTTCGTGGAGAACCTCCGT
TTTGTCAGGCCTGAGCTAC -> TTGTCAGGCCTGAGCTACA
TTACATTGTTCAAATGACG -> TACATTGTTCAAATGACGT
TAAGACGGTAGGATCACAA -> AAGACGGTAGGATCACAAT
TAGAAAAAAATACACGTCT -> AGAAAAAAATACACGTCTA
GGGAAGTTCGCCTGTACAT -> GGAAGTTCGCCTGTACATG
CTCCTATGCTAAGACTAAT -> TCCTATGCTAAGACTAATA
ATAAGCAATCCGCTGATGA -> TAAGCAATCCGCTGATGAA
AGTTCTACATCCTGTTACG -> GTTCTACATCCTGTTACGC
AATGAGCCCCGGCCTGTCG -> ATGAGCCCCGGCCTGTCGA
TTGAAATGTCGTTTTCCTA -> TGAAATGTCGTTTTCCTAG
GGGCGAAGATCTCGTATGT -> GGCGAAGATCTCGTATGTC
GCGGGTTATGGTCCTTTAA -> CGGGTTATGGTCCTTTAAA
ACGGATCGTACAAACCGTA -> CGGATCGTACAAACCGTAT
CTAATTAAACGCCAATTTG -> TAATTAAACGCCAATTTGT
CGACACCCTACTAGTCGGA -> GACACCCTACTAGTCGGAC
TAGTAAGAGGCACCCGGCC -> AGTAAGAGGCACCCGGCCG
TACTATGTGGGCCGCCTCC -> ACTATGTGGGCCGCCTCCC
AGAAGCTTTGCCGACGCCC -> GAAGCTTTGCCGACGCCCC
ATGAGCCCCGGCCTGTCGA -> TGAGCCCCGGCCTGTCGAG
CTCCCAGGGCTTGAGATTA -> TCCCAGGGCTTGAGATTAT
CTTCGCCCACTGCTAAATT -> TTCGCCCACTGCTAAATTC
TTAGGATGAACTCTGGGTG -> TAGGATGAACTCTGGGTGA
AAGACATGACGACTCATTA -> AGACATGACGACTCATTAC
CGCCTGTACATGTGCAGTC -> GCCTGTACATGTGCAGTCG
GCCATAGCGGGATAAGAGC -> CCATAGCGGGATAAGAGCA
AATTCAGCAGCCGTAGGGG -> ATTCAGCAGCCGTAGGGGG
TTGCGGGAAAATCTAGAGA -> TGCGGGAAAATCTAGAGAA
CGTGTCCATGCTAATAATA -> GTGTCCATGCTAATAATAA
CGACTCATTACCAACTTAG -> GACTCATTACCAACTTAGT
TATACAGTTGGTTGCCGAT -> ATACAGTTGGTTGCCGATT
TAAGAGCACCCGACTCTCG -> AAGAGCACCCGACTCTCGC
AATGGCGACACCCTACTAG -> ATGGCGACACCCTACTAGT
ATGCTCAGCTAAAACGGAT -> TGCTCAGCTAAAACGGATC
ACGCTTTGATCCGCGATTC -> CGCTTTGATCCGCGATTCG
AGAAATCTGCCTCCTACCG -> GAAATCTGCCTCCTACCGT
CAGCTGGTGTCAAGGCAGC -> AGCTGGTGTCAAGGCAGCT
GGGGGGATATCGCTACACG -> GGGGGATATCGCTACACGT
TGGGCCGCCTCCCAGGGCT -> GGGCCGCCTCCCAGGGCTT
CACCAAAATGGCTGGCTTC -> ACCAAAATGGCTGGCTTCA
CAGGGGTACTCGATTAAAG -> AGGGGTACTCGATTAAAGG
TATATCTTGTAGCCACGCT -> ATATCTTGTAGCCACGCTT
GTCCTTTAAATCTCAGACC -> TCCTTTAAATCTCAGACCC
AGATTCGACAGTCCGAAAT -> GATTCGACAGTCCGAAATT
CCTAGAAAAAAATACGGTT -> CTAGAAAAAAATACGGTTT
GTCTGCAAGACATGACGAC -> TCTGCAAGACATGACGACT
ACCATGCGTTTCAACCGCG -> CCATGCGTTTCAACCGCGC
ACCGCGCTGCAGGCAGGGG -> CCGCGCTGCAGGCAGGGGT
CCGTCGACAAACAAGCCAC -> CGTCGACAAACAAGCCACT
GGCGACACCCTACTAGTCG -> GCGACACCCTACTAGTCGG
ATGCCGGCTGTTGTTGTTC -> TGCCGGCTGTTGTTGTTCC
AGGTCACCTTATTGATCTT -> GGTCACCTTATTGATCTTC
GGGGTCAAACCCAGTAATC -> GGGTCAAACCCAGTAATCT
TAGCGGGATAAGAGCACCC -> AGCGGGATAAGAGCACCCG
TTCAGACCCTTATCACAAA -> TCAGACCCTTATCACAAAA
TCTGCCAGGGAAGTTTTTC -> CTGCCAGGGAAGTTTTTCC
TCCTTATATCTTGTAGCCA -> CCTTATATCTTGTAGCCAC
ACAGACTAATTAAACGCCA -> CAGACTAATTAAACGCCAA
GGCACCCGGCCGCCAAGAA -> GCACCCGGCCGCCAAGAAA
AGTTGGTTGCCGATTCCGT -> GTTGGTTGCCGATTCCGTA
AAGAGGCACCCGGCCGCCA -> AGAGGCACCCGGCCGCCAA
GAGAAGCTTTGCCGACGCC -> AGAAGCTTTGCCGACGCCC
TCGTATGGCCGGCTGTGCG -> CGTATGGCCGGCTGTGCGT
ATTATCCGACATATCGTAA -> TTATCCGACATATCGTAAA
GAAAAAAATACCCAGAAAT -> AAAAAAATACCCAGAAATA
CGTAGGGGGGGATATCGCT -> GTAGGGGGGGATATCGCTA
CCTACTAGTCGGACTATAG -> CTACTAGTCGGACTATAGC
CACTTAGGATGAACTCTGG -> ACTTAGGATGAACTCTGGG
TTTCAATTGCTAGTTCTAC -> TTCAATTGCTAGTTCTACA
AAACGCTTTGATCCGCGAT -> AACGCTTTGATCCGCGATT
CCGTCCATGGGCCTAGAGT -> CGTCCATGGGCCTAGAGTC
ACAGGTCACCTTATTGATC -> CAGGTCACCTTATTGATCT
TCAACAAATCAGCATGCTC -> CAACAAATCAGCATGCTCA
CGCGCTCTACAGTCAACTG -> GCGCTCTACAGTCAACTGC
CAACAAATCAGCATGCTCA -> AACAAATCAGCATGCTCAG
TCTGCCTCCTACCGTGTTT -> CTGCCTCCTACCGTGTTTC
ATGAATCAACAAATCAGCA -> TGAATCAACAAATCAGCAT
TAATAATAATAAGCCATAG -> AATAATAATAAGCCATAGC
TCACAATTCCCAGCTGCCG -> CACAATTCCCAGCTGCCGG
AGCCCCGGCCTGTCGAGAC -> GCCCCGGCCTGTCGAGACT
GTCTCTCAGTCATTATCCG -> TCTCTCAGTCATTATCCGA
GGCCCGGTTACCACGCACG -> GCCCGGTTACCACGCACGA
GTGCCTTAGTAAGAGGCAC -> TGCCTTAGTAAGAGGCACC
GCCCTTGCTCCCGGCCATA -> CCCTTGCTCCCGGCCATAC
CATAGCGGGATAAGAGCAC -> ATAGCGGGATAAGAGCACC
CGACAGTCCGAAATTCATG -> GACAGTCCGAAATTCATGA
CGCTAAAACCAGATTCGAC -> GCTAAAACCAGATTCGACA
TGAACTCTGGGTGAGGCGT -> GAACTCTGGGTGAGGCGTG
ACTATGTGGGCCGCCTCCC -> CTATGTGGGCCGCCTCCCA
GTCCGGATCGTCTCTCAGT -> TCCGGATCGTCTCTCAGTC
TTAGATGTGGGTAATTGAG -> TAGATGTGGGTAATTGAGT
CGGCCTGTCGAGACTCTTT -> GGCCTGTCGAGACTCTTTG
TGCCTACTAAGCCTGGACC -> GCCTACTAAGCCTGGACCG
TAATTGAGTGAGCGTAACA -> AATTGAGTGAGCGTAACAG
CACTCAATAATGAAGACCA -> ACTCAATAATGAAGACCAT
CTCGCGCTCTACAGTCAAC -> TCGCGCTCTACAGTCAACT
CTGGACCGTAGCCACACCG -> TGGACCGTAGCCACACCGA
GCTCCGACGGGCAGAGAAG -> CTCCGACGGGCAGAGAAGC
GAGCCATGTGACACAGGGC -> AGCCATGTGACACAGGGCG
ACAAACCGTATGTATAGCT -> CAAACCGTATGTATAGCTT
AATAATAAGCCATAGCGGG -> ATAATAAGCCATAGCGGGA
TAAAATGCTGGTTTCAATT -> AAAATGCTGGTTTCAATTG
TTATCCGACATATCGTAAA -> TATCCGACATATCGTAAAT
TACATTGTTCAAATGACGT -> ACATTGTTCAAATGACGTC
TCTAACATGGTTCGTTTTC -> CTAACATGGTTCGTTTTCC
AGGTCCGGCCTGTCGAGAC -> GGTCCGGCCTGTCGAGACT
CTTTCGAGTAATAGAGGTC -> TTTCGAGTAATAGAGGTCG
CGCTGCAAACGCTTTGATC -> GCTGCAAACGCTTTGATCC
AGACTCTAACATGGTTCGT -> GACTCTAACATGGTTCGTT
TAACAGGTCACCTTATTGA -> AACAGGTCACCTTATTGAT
GTATGTATAGCTTCGAGTC -> TATGTATAGCTTCGAGTCG
AGTGTACTTATGGTAGCGG -> GTGTACTTATGGTAGCGGG
TGTGGGCGAAGATCTCGTA -> GTGGGCGAAGATCTCGTAT
CACGATGCGGGAATGCTGG -> ACGATGCGGGAATGCTGGG
TGCTAAGACTAATAAGCAA -> GCTAAGACTAATAAGCAAT
TCCTAGAAAAAAATACCCA -> CCTAGAAAAAAATACCCAG
GGGCCTAGAGTCGGGCCAT -> GGCCTAGAGTCGGGCCATG
AATGACAGGTCCGGCCTGT -> ATGACAGGTCCGGCCTGTC
CTCCTTATATCTTGTAGCC -> TCCTTATATCTTGTAGCCA
GCTTTGATCCGCGATTCGT -> CTTTGATCCGCGATTCGTC
TCGTCTGCAAGACATGACG -> CGTCTGCAAGACATGACGA
GGGAATGCTGGGTAAGACG -> GGAATGCTGGGTAAGACGG
CTTCGCGGGTTATGGTCCT -> TTCGCGGGTTATGGTCCTT
CGTTTCCATGTGGGCGAAG -> GTTTCCATGTGGGCGAAGA
GCATGATGGGAGCCCTTAT -> CATGATGGGAGCCCTTATC
GTAAAATGCTGGTTTCAAT -> TAAAATGCTGGTTTCAATT
CAGTAATCTAAAAAGCAAT -> AGTAATCTAAAAAGCAATC
TGCTCCCGGCCATACGGCT -> GCTCCCGGCCATACGGCTC
TGCGGGAAAATCTAGAGAA -> GCGGGAAAATCTAGAGAAC
TAAAAAGCAATCCCTTGAA -> AAAAAGCAATCCCTTGAAC
GAAAAAAATACGAAAGGCA -> AAAAAAATACGAAAGGCAC
GCCAAGAAATCTGCCTCCT -> CCAAGAAATCTGCCTCCTA
TACAATGAGCCCCGGCCTG -> ACAATGAGCCCCGGCCTGT
ACGGTTTAAAGCCCAGCTT -> CGGTTTAAAGCCCAGCTTT
CGATTCGTCTGCAAGACAT -> GATTCGTCTGCAAGACATG
CTTGGCCGTTTCCATGTGG -> TTGGCCGTTTCCATGTGGG
TAGCAGAATACTATGTGGG -> AGCAGAATACTATGTGGGC
ATCCGCTGATGAAGTGCCT -> TCCGCTGATGAAGTGCCTT
CAAAATGGCTGGCTTCAGA -> AAAATGGCTGGCTTCAGAC
TTTCGAGTAATAGAGGTCG -> TTCGAGTAATAGAGGTCGT
GGGAGCCCTTATCGAGTGG -> GGAGCCCTTATCGAGTGGC
GCCTGTCGAGACTCTCCAC -> CCTGTCGAGACTCTCCACG
TACTCGATTAAAGGTCACT -> ACTCGATTAAAGGTCACTG
GCTGTTGTTGTTCCCGAAA -> CTGTTGTTGTTCCCGAAAG
GGTGTACAATGAGCCCCGG -> GTGTACAATGAGCCCCGGC
GCGGAGCCATGTGACACAG -> CGGAGCCATGTGACACAGG
CCGCCTCCCAGGGCTTGAG -> CGCCTCCCAGGGCTTGAGA
GAGAACCTCCGTATCAAGT -> AGAACCTCCGTATCAAGTG
AGAACTTTCGAGTAATAGA -> GAACTTTCGAGTAATAGAG
GGATATCGCTACACGTTAC -> GATATCGCTACACGTTACT
CTACGCGACCATGCGTTTC -> TACGCGACCATGCGTTTCA
ACTAGTCGGACTATAGCAT -> CTAGTCGGACTATAGCATC
CTTATGCGAGGTATAAACC -> TTATGCGAGGTATAAACCT
CCTCGGGCGCTTCGTGGAG -> CTCGGGCGCTTCGTGGAGA
CCACGACCGATTTTTCCTA -> CACGACCGATTTTTCCTAG
AAGTTTTTCCTAGAAAAAA -> AGTTTTTCCTAGAAAAAAA
ATTCATGACCCCCCCTCGG -> TTCATGACCCCCCCTCGGG
TCAGACCCCTCAAACATAT -> CAGACCCCTCAAACATATT
GCTTGAGATTATATTGGTG -> CTTGAGATTATATTGGTGA
GTCCATGGGCCTAGAGTCG -> TCCATGGGCCTAGAGTCGG
ACGCTAAAACCAGATTCGA -> CGCTAAAACCAGATTCGAC
ACCCTTATCACAAAAATTC -> CCCTTATCACAAAAATTCG
TGGTCCTTTAAATCTCAGA -> GGTCCTTTAAATCTCAGAC
TGACACGGTGTACAATGAG -> GACACGGTGTACAATGAGC
TACGCGACCATGCGTTTCA -> ACGCGACCATGCGTTTCAA
CTAGTCCGCGCATGATGGG -> TAGTCCGCGCATGATGGGA
TAGGATGAACTCTGGGTGA -> AGGATGAACTCTGGGTGAG
AGTCGTCACGTCTGCTAAA -> GTCGTCACGTCTGCTAAAG
CAGAATACTATGTGGGCCG -> AGAATACTATGTGGGCCGC
CTCTCCACGACCGATTTTT -> TCTCCACGACCGATTTTTC
ATGACCCCCCCTCGGGCGC -> TGACCCCCCCTCGGGCGCT
CCCCGTCGACAAACAAGCC -> CCCGTCGACAAACAAGCCA
AGATGTGGGTAATTGAGTG -> GATGTGGGTAATTGAGTGA
TCAGCTGGTGTCAAGGCAG -> CAGCTGGTGTCAAGGCAGC
CGTAGCCACACCGATCCGT -> GTAGCCACACCGATCCGTA
GACACCCTACTAGTCGGAC -> ACACCCTACTAGTCGGACT
AGGCTGTTCTTCACCATAT -> GGCTGTTCTTCACCATATC
AAGATAAGTTTCGAGATCC -> AGATAAGTTTCGAGATCCC
GGACTATAGCATCACAATA -> GACTATAGCATCACAATAG
AGGTATAAACCTTTGCAAA -> GGTATAAACCTTTGCAAAC
CGAATAGCGACCTGTATAC -> GAATAGCGACCTGTATACA
CGGCCATACGGCTCCGACG -> GGCCATACGGCTCCGACGG
CGATGCGGGAATGCTGGGT -> GATGCGGGAATGCTGGGTA
AACAAGGGGTTTTGCACAA -> ACAAGGGGTTTTGCACAAT
TACAGTTGGTTGCCGATTC -> ACAGTTGGTTGCCGATTCC
CCTCCGTATCAAGTGTACT -> CTCCGTATCAAGTGTACTT
ACTTAGGATGAACTCTGGG -> CTTAGGATGAACTCTGGGT
GCCTAGAGTCGGGCCATGC -> CCTAGAGTCGGGCCATGCC
GATCGGTCGACGCCCTTGC -> ATCGGTCGACGCCCTTGCT
AAAGCCCAGCTTTGTTCCT -> AAGCCCAGCTTTGTTCCTT
TCACCTTATTGATCTTCGC -> CACCTTATTGATCTTCGCC
TCCTTAAATACGACATGTA -> CCTTAAATACGACATGTAA
ATGCTGGGTAAGACGGTAG -> TGCTGGGTAAGACGGTAGG
ATGCGGGAATGCTGGGTAA -> TGCGGGAATGCTGGGTAAG
TCATGCTAATGGCGACACC -> CATGCTAATGGCGACACCC
CGCAACAAGGGGTTTTGCA -> GCAACAAGGGGTTTTGCAC
TAATTAAACGCCAATTTGT -> AATTAAACGCCAATTTGTC
CATGCCTACTAAGCCTGGA -> ATGCCTACTAAGCCTGGAC
CAATTGCTAGTTCTACATC -> AATTGCTAGTTCTACATCC
ATCGTAAATTCGGCTCCTA -> TCGTAAATTCGGCTCCTAT
ACACGTCTACGCGACCATG -> CACGTCTACGCGACCATGC
AATACCCAGAAATAATGAC -> ATACCCAGAAATAATGACA
CCTTGAACTGTAAGGCCTT -> CTTGAACTGTAAGGCCTTC
ACGCCCTTGCTCCCGGCCA -> CGCCCTTGCTCCCGGCCAT
GCTACACGTTACTTGATCG -> CTACACGTTACTTGATCGG
ATAAGAGCACCCGACTCTC -> TAAGAGCACCCGACTCTCG
AATAGAGGTCGTCAGCTGG -> ATAGAGGTCGTCAGCTGGT
ACCTTATTGATCTTCGCCC -> CCTTATTGATCTTCGCCCA
CTTGAGATTATATTGGTGA -> TTGAGATTATATTGGTGAT
ATCTCAGACCCCTCAAACA -> TCTCAGACCCCTCAAACAT
CGAAAGGCACGCTGCAAAC -> GAAAGGCACGCTGCAAACG
GATGGCCCGGTTACCACGC -> ATGGCCCGGTTACCACGCA
CGACGCCCTTGCTCCCGGC -> GACGCCCTTGCTCCCGGCC
CGTCAGCTGGTGTCAAGGC -> GTCAGCTGGTGTCAAGGCA
CTTAGTCCGGATCGTCTCT -> TTAGTCCGGATCGTCTCTC
AGAAAAAAATACACGTCTA -> GAAAAAAATACACGTCTAC
GCCATGCCTACTAAGCCTG -> CCATGCCTACTAAGCCTGG
CTCCGTATCAAGTGTACTT -> TCCGTATCAAGTGTACTTA
CAGCAGCCGTAGGGGGGGA -> AGCAGCCGTAGGGGGGGAT
TGTTCAAATGACGTCACCG -> GTTCAAATGACGTCACCGT
GTACTCTTACAGACTAATT -> TACTCTTACAGACTAATTA
CATGACCCCCCCTCGGGCG -> ATGACCCCCCCTCGGGCGC
GCCTTCGCGGGTTATGGTC -> CCTTCGCGGGTTATGGTCC
GCAAGACATGACGACTCAT -> CAAGACATGACGACTCATT
CTCAAACATATTGCTGAGG -> TCAAACATATTGCTGAGGC
TTGCCGATTCCGTATCGTC -> TGCCGATTCCGTATCGTCT
ATACTATGTGGGCCGCCTC -> TACTATGTGGGCCGCCTCC
CGCGCATGATGGGAGCCCT -> GCGCATGATGGGAGCCCTT
GTGGGCGAAGATCTCGTAT -> TGGGCGAAGATCTCGTATG
TTGAGATTATATTGGTGAT -> TGAGATTATATTGGTGATG
GTAGCCACGCTTCCTATAC -> TAGCCACGCTTCCTATACC
CAAGCCACTCAATAATGAA -> AAGCCACTCAATAATGAAG
TATGGTCCTTTAAATCTCA -> ATGGTCCTTTAAATCTCAG
TGATGTGCCAGGCTGTTCT -> GATGTGCCAGGCTGTTCTT
CCCGTCTGTATGCCGGCTG -> CCGTCTGTATGCCGGCTGT
CGACTCTCGCGCTCTACAG -> GACTCTCGCGCTCTACAGT
ACCCCTGGGGCTTCTAGTC -> CCCCTGGGGCTTCTAGTCC
GACGCCCTTGCTCCCGGCC -> ACGCCCTTGCTCCCGGCCA
AAGCAATCCGCTGATGAAG -> AGCAATCCGCTGATGAAGT
TGGCCGGCTGTGCGTGGAC -> GGCCGGCTGTGCGTGGACA
CAATATATGTTTGTCCTTA -> AATATATGTTTGTCCTTAA
GCCGTATACGTCGAGATGG -> CCGTATACGTCGAGATGGC
CCCTCGGGCGCTTCGTGGA -> CCTCGGGCGCTTCGTGGAG
GATAAGTTTCGAGATCCCT -> ATAAGTTTCGAGATCCCTT
CAACAAGGGGTTTTGCACA -> AACAAGGGGTTTTGCACAA
AAATGTCGTTTTCCTAGAA -> AATGTCGTTTTCCTAGAAA
ACAAACAAGCCACTCAATA -> CAAACAAGCCACTCAATAA
GCGCTCTACAGTCAACTGC -> CGCTCTACAGTCAACTGCG
ACAGATCCAAGCAATACAT -> CAGATCCAAGCAATACATT
CCTACTAAGCCTGGACCGT -> CTACTAAGCCTGGACCGTA
GCTCCTATGCTAAGACTAA -> CTCCTATGCTAAGACTAAT
GCTGCCGGAATTTACTCTA -> CTGCCGGAATTTACTCTAT
TGCCAGGCTGTTCTTCACC -> GCCAGGCTGTTCTTCACCA
ATATTGGTGATGTGCCAGG -> TATTGGTGATGTGCCAGGC
TCATTATCCGACATATCGT -> CATTATCCGACATATCGTA
ACCGATTTTTCCTAGAAAA -> CCGATTTTTCCTAGAAAAA
GTCTGCTAAAGGGCCACCA -> TCTGCTAAAGGGCCACCAA
ATCCGCGATTCGTCTGCAA -> TCCGCGATTCGTCTGCAAG
CACCGTAGACTCGTGACAC -> ACCGTAGACTCGTGACACG
AGGGGTCAAACCCAGTAAT -> GGGGTCAAACCCAGTAATC
CTGTCGAGACTCTCCACGA -> TGTCGAGACTCTCCACGAC
AGCATGCTCAGCTAAAACG -> GCATGCTCAGCTAAAACGG
TGACACAGGGCGTCTTGGC -> GACACAGGGCGTCTTGGCC
GTGCGTGGACAGATCCAAG -> TGCGTGGACAGATCCAAGC
GCGCATGATGGGAGCCCTT -> CGCATGATGGGAGCCCTTA
GCGAGGTATAAACCTTTGC -> CGAGGTATAAACCTTTGCA
TAGAAAAAAATACGAAAGG -> AGAAAAAAATACGAAAGGC
CCCCCGTCGACAAACAAGC -> CCCCGTCGACAAACAAGCC
CGTGTTTCATGAATCAACA -> GTGTTTCATGAATCAACAA
GTATGTCGTGTCCATGCTA -> TATGTCGTGTCCATGCTAA
GGCCGAATAGCGACCTGTA -> GCCGAATAGCGACCTGTAT
CGGGTTATGGTCCTTTAAA -> GGGTTATGGTCCTTTAAAT
CCGAATAGCGACCTGTATA -> CGAATAGCGACCTGTATAC
CCCGACTCTCGCGCTCTAC -> CCGACTCTCGCGCTCTACA
TCCCAGCTGCCGGAATTTA -> CCCAGCTGCCGGAATTTAC
GTCGAGACTCTTTGAAATG -> TCGAGACTCTTTGAAATGT
GCCAGGCTGTTCTTCACCA -> CCAGGCTGTTCTTCACCAT
TAATTAGGGGTCAAACCCA -> AATTAGGGGTCAAACCCAG
TGAACTGTAAGGCCTTCGC -> GAACTGTAAGGCCTTCGCG
ATTCGACAGTCCGAAATTC -> TTCGACAGTCCGAAATTCA
AACTTTGCCGGGAGCCCCC -> ACTTTGCCGGGAGCCCCCG
CCGTACTCTTACAGACTAA -> CGTACTCTTACAGACTAAT
GGTGAGGCGTGTTGGCTCT -> GTGAGGCGTGTTGGCTCTT
GGTCCTTTAAATCTCAGAC -> GTCCTTTAAATCTCAGACC
AGCCACTCAATAATGAAGA -> GCCACTCAATAATGAAGAC
TCTACGCGACCATGCGTTT -> CTACGCGACCATGCGTTTC
AAGTGCCTTAGTAAGAGGC -> AGTGCCTTAGTAAGAGGCA
TACATGTGCAGTCGTCACG -> ACATGTGCAGTCGTCACGT
CGACCCCTGGGGCTTCTAG -> GACCCCTGGGGCTTCTAGT
TAGCCACGCTTCCTATACC -> AGCCACGCTTCCTATACCT
ACGCTTCCTATACCTGGTT -> CGCTTCCTATACCTGGTTA
GCCGATTCCGTATCGTCTC -> CCGATTCCGTATCGTCTCC
CATCACAATAGCGCTGATT -> ATCACAATAGCGCTGATTG
ACGTCACCGTCCATGGGCC -> CGTCACCGTCCATGGGCCT
GGCTCTTGATTAGGCTGAA -> GCTCTTGATTAGGCTGAAC
TCTTGGCCGTTTCCATGTG -> CTTGGCCGTTTCCATGTGG
TGTCATATTCGTATGGCCG -> GTCATATTCGTATGGCCGG
TCGAGCAGAACCCAAATGT -> CGAGCAGAACCCAAATGTG
TACCGTGTTTCATGAATCA -> ACCGTGTTTCATGAATCAA
TGTGCGTGGACAGATCCAA -> GTGCGTGGACAGATCCAAG
ACAAAAATTCGAGCAGAAC -> CAAAAATTCGAGCAGAACC
TGGACAGATCCAAGCAATA -> GGACAGATCCAAGCAATAC
CTGCTAAAGGGCCACCAAA -> TGCTAAAGGGCCACCAAAA
TAAGCCATAGCGGGATAAG -> AAGCCATAGCGGGATAAGA
CCGCGCATGATGGGAGCCC -> CGCGCATGATGGGAGCCCT
CTCTTACAGACTAATTAAA -> TCTTACAGACTAATTAAAC
GACCCCTGGGGCTTCTAGT -> ACCCCTGGGGCTTCTAGTC
TCCCTTACATTGTTCAAAT -> CCCTTACATTGTTCAAATG
GTTTTGCACAATATATGTT -> TTTTGCACAATATATGTTT
ATAATTAGGGGTCAAACCC -> TAATTAGGGGTCAAACCCA
GGTCCGGCCTGTCGAGACT -> GTCCGGCCTGTCGAGACTC
GAATGTTAAAAGTACGCTA -> AATGTTAAAAGTACGCTAA
TATCAAGTGTACTTATGGT -> ATCAAGTGTACTTATGGTA
GTCAAACCCAGTAATCTAA -> TCAAACCCAGTAATCTAAA
TTCGTCTGCAAGACATGAC -> TCGTCTGCAAGACATGACG
CCGGATCGTCTCTCAGTCA -> CGGATCGTCTCTCAGTCAT
TGAAGTGCCTTAGTAAGAG -> GAAGTGCCTTAGTAAGAGG
TCCATGGGCCTAGAGTCGG -> CCATGGGCCTAGAGTCGGG
TACACGTCTACGCGACCAT -> ACACGTCTACGCGACCATG
GTACAAACCGTATGTATAG -> TACAAACCGTATGTATAGC
TGCAGGCAGGGGTACTCGA -> GCAGGCAGGGGTACTCGAT
GACGACTCATTACCAACTT -> ACGACTCATTACCAACTTA
GCCATACGGCTCCGACGGG -> CCATACGGCTCCGACGGGC
TCAGCAGCCGTAGGGGGGG -> CAGCAGCCGTAGGGGGGGA
TAGCGCTGATTGTTGCTTA -> AGCGCTGATTGTTGCTTAC
CCTGTATACAGTTGGTTGC -> CTGTATACAGTTGGTTGCC
GGTAATTGAGTGAGCGTAA -> GTAATTGAGTGAGCGTAAC
CTAGAAAAAAATACGAAAG -> TAGAAAAAAATACGAAAGG
TGTCGAGACTCTTTGAAAT -> GTCGAGACTCTTTGAAATG
AAATGTGAGCGCGGAGCCA -> AATGTGAGCGCGGAGCCAT
TGAGCTACACGACCCCTGG -> GAGCTACACGACCCCTGGG
TTATCGAGTGGCTCACCGT -> TATCGAGTGGCTCACCGTA
ATCACAAAAATTCGAGCAG -> TCACAAAAATTCGAGCAGA
TCGGACTATAGCATCACAA -> CGGACTATAGCATCACAAT
TCTAGAGAACTTTCGAGTA -> CTAGAGAACTTTCGAGTAA
TGTCCTTAAATACGACATG -> GTCCTTAAATACGACATGT
TCTTCGCCCACTGCTAAAT -> CTTCGCCCACTGCTAAATT
CTAAGATAAGTTTCGAGAT -> TAAGATAAGTTTCGAGATC
CGACGCCCCGTCTGTATGC -> GACGCCCCGTCTGTATGCC
CAACGGCGCACTTAGGATG -> AACGGCGCACTTAGGATGA
CCATGGGCCTAGAGTCGGG -> CATGGGCCTAGAGTCGGGC
GGCGCACTTAGGATGAACT -> GCGCACTTAGGATGAACTC
TCCGCTGATGAAGTGCCTT -> CCGCTGATGAAGTGCCTTA
ATGGCGACACCCTACTAGT -> TGGCGACACCCTACTAGTC
TAGCATCACAATAGCGCTG -> AGCATCACAATAGCGCTGA
CGAGACTCTGCCAGGGAAG -> GAGACTCTGCCAGGGAAGT
CCTTTGCAAACAGGCGGAT -> CTTTGCAAACAGGCGGATA
TGTAGCCACGCTTCCTATA -> GTAGCCACGCTTCCTATAC
TCTAAAAAGCAATCCCTTG -> CTAAAAAGCAATCCCTTGA
GACTCTAACATGGTTCGTT -> ACTCTAACATGGTTCGTTT
GTGTACAATGAGCCCCGGC -> TGTACAATGAGCCCCGGCC
GCCGGGAGCCCCCGTCGAC -> CCGGGAGCCCCCGTCGACA
TAATAAGCAATCCGCTGAT -> AATAAGCAATCCGCTGATG
ATTAGGCTGAACCCACCTC -> TTAGGCTGAACCCACCTCC
CAAATCAGCATGCTCAGCT -> AAATCAGCATGCTCAGCTA
TCTGCAAGACATGACGACT -> CTGCAAGACATGACGACTC
TCGAGACTCTAACATGGTT -> CGAGACTCTAACATGGTTC
AAAGGGCCACCAAAATGGC -> AAGGGCCACCAAAATGGCT
TCACAAAAATTCGAGCAGA -> CACAAAAATTCGAGCAGAA
TGAGCGCGGAGCCATGTGA -> GAGCGCGGAGCCATGTGAC
TACGACATGTAAAATGCTG -> ACGACATGTAAAATGCTGG
TTATATCTTGTAGCCACGC -> TATATCTTGTAGCCACGCT
ACCACGCACGATGCGGGAA -> CCACGCACGATGCGGGAAT
CGGGCCATGCCTACTAAGC -> GGGCCATGCCTACTAAGCC
CTTATGGTAGCGGGAAGTT -> TTATGGTAGCGGGAAGTTC
ATCCCTTGAACTGTAAGGC -> TCCCTTGAACTGTAAGGCC
ACCGATCCGTACTCTTACA -> CCGATCCGTACTCTTACAG
GGGGTTTTGCACAATATAT -> GGGTTTTGCACAATATATG
GTGGGTAATTGAGTGAGCG -> TGGGTAATTGAGTGAGCGT
GACAAACAAGCCACTCAAT -> ACAAACAAGCCACTCAATA
AAATAATGACAGGTCCGGC -> AATAATGACAGGTCCGGCC
TGAGTGAGCGTAACAGGTC -> GAGTGAGCGTAACAGGTCA
CGTCACCGTCCATGGGCCT -> GTCACCGTCCATGGGCCTA
ATCAGCATGCTCAGCTAAA -> TCAGCATGCTCAGCTAAAA
AAAAGAAGTGCAGGGTAAA -> AAAGAAGTGCAGGGTAAAG
GAGTCGGGCCATGCCTACT -> AGTCGGGCCATGCCTACTA
ACCAGATTCGACAGTCCGA -> CCAGATTCGACAGTCCGAA
GCTCAGCTAAAACGGATCG -> CTCAGCTAAAACGGATCGT
TATGCGAGGTATAAACCTT -> ATGCGAGGTATAAACCTTT
GAGGTCGTCAGCTGGTGTC -> AGGTCGTCAGCTGGTGTCA
CAGACTAATTAAACGCCAA -> AGACTAATTAAACGCCAAT
CAGGGTAAAGAAAAGAAGG -> AGGGTAAAGAAAAGAAGGG
CCAGAAATAATGACAGGTC -> CAGAAATAATGACAGGTCC
CACCTTATTGATCTTCGCC -> ACCTTATTGATCTTCGCCC
TACATCCTGTTACGCCGTA -> ACATCCTGTTACGCCGTAT
TAAAAGTACGCTAAAACCA -> AAAAGTACGCTAAAACCAG
CTGCAGGCAGGGGTACTCG -> TGCAGGCAGGGGTACTCGA
AATAATAATAAGCCATAGC -> ATAATAATAAGCCATAGCG
TCTTACAGACTAATTAAAC -> CTTACAGACTAATTAAACG
ACACAGGGCGTCTTGGCCG -> CACAGGGCGTCTTGGCCGT
ACCCGACTCTCGCGCTCTA -> CCCGACTCTCGCGCTCTAC
TCCAAGCAATACATTAGAT -> CCAAGCAATACATTAGATG
CAGCATGCTCAGCTAAAAC -> AGCATGCTCAGCTAAAACG
TTCCCAGCTGCCGGAATTT -> TCCCAGCTGCCGGAATTTA
TGTTCCCGAAAGTTACCCT -> GTTCCCGAAAGTTACCCTA
AGGCCTTCGCGGGTTATGG -> GGCCTTCGCGGGTTATGGT
TATGTCGTGTCCATGCTAA -> ATGTCGTGTCCATGCTAAT
TTACAGACTAATTAAACGC -> TACAGACTAATTAAACGCC
TTCGTGGAGAACCTCCGTA -> TCGTGGAGAACCTCCGTAT
CTCTGGGTGAGGCGTGTTG -> TCTGGGTGAGGCGTGTTGG
TCAAACATATTGCTGAGGC -> CAAACATATTGCTGAGGCC
CCCCGTCTGTATGCCGGCT -> CCCGTCTGTATGCCGGCTG
CCAAGCAATACATTAGATG -> CAAGCAATACATTAGATGT
CGACATATCGTAAATTCGG -> GACATATCGTAAATTCGGC
GAAGCTTTGCCGACGCCCC -> AAGCTTTGCCGACGCCCCG
AGACTCTCCACGACCGATT -> GACTCTCCACGACCGATTT
GAACTCTGGGTGAGGCGTG -> AACTCTGGGTGAGGCGTGT
CATTGTTCAAATGACGTCA -> ATTGTTCAAATGACGTCAC
CGTCCATGGGCCTAGAGTC -> GTCCATGGGCCTAGAGTCG
ATACGACATGTAAAATGCT -> TACGACATGTAAAATGCTG
CTAAGCCTGGACCGTAGCC -> TAAGCCTGGACCGTAGCCA
GCGTTTCAACCGCGCTGCA -> CGTTTCAACCGCGCTGCAG
GATCCCTTACATTGTTCAA -> ATCCCTTACATTGTTCAAA
GCCTGGACCGTAGCCACAC -> CCTGGACCGTAGCCACACC
CTGCAAACGCTTTGATCCG -> TGCAAACGCTTTGATCCGC
TAAGACTAATAAGCAATCC -> AAGACTAATAAGCAATCCG
CGGGCAGAGAAGCTTTGCC -> GGGCAGAGAAGCTTTGCCG
ACTGCGCAACAAGGGGTTT -> CTGCGCAACAAGGGGTTTT
GTAGGATCACAATTCCCAG -> TAGGATCACAATTCCCAGC
CGACCATGCGTTTCAACCG -> GACCATGCGTTTCAACCGC
GGTTATGGTCCTTTAAATC -> GTTATGGTCCTTTAAATCT
CATATCGTAAATTCGGCTC -> ATATCGTAAATTCGGCTCC
AGCTACACGACCCCTGGGG -> GCTACACGACCCCTGGGGC
GCCTCCCAGGGCTTGAGAT -> CCTCCCAGGGCTTGAGATT
ATAGCATCACAATAGCGCT -> TAGCATCACAATAGCGCTG
TGACAGGTCCGGCCTGTCG -> GACAGGTCCGGCCTGTCGA
GATTCCGTATCGTCTCCTC -> ATTCCGTATCGTCTCCTCC
CCTAAGATAAGTTTCGAGA -> CTAAGATAAGTTTCGAGAT
CGCATGATGGGAGCCCTTA -> GCATGATGGGAGCCCTTAT
TTTACTCTATAAAAGAAGT -> TTACTCTATAAAAGAAGTG
ACAGGGCGTCTTGGCCGTT -> CAGGGCGTCTTGGCCGTTT
TACTCTATAAAAGAAGTGC -> ACTCTATAAAAGAAGTGCA
CGATCCGTACTCTTACAGA -> GATCCGTACTCTTACAGAC
GTAAGAGGCACCCGGCCGC -> TAAGAGGCACCCGGCCGCC
AACCGTATGTATAGCTTCG -> ACCGTATGTATAGCTTCGA
GTTAAAAGTACGCTAAAAC -> TTAAAAGTACGCTAAAACC
ACCCTACTAGTCGGACTAT -> CCCTACTAGTCGGACTATA
CCACACCGATCCGTACTCT -> CACACCGATCCGTACTCTT
TCTATAAAAGAAGTGCAGG -> CTATAAAAGAAGTGCAGGG
GCAAACAGGCGGATAGCTC -> CAAACAGGCGGATAGCTCG
TGAGGCGTGTTGGCTCTTG -> GAGGCGTGTTGGCTCTTGA
ACGGCGCACTTAGGATGAA -> CGGCGCACTTAGGATGAAC
GGGATAAGAGCACCCGACT -> GGATAAGAGCACCCGACTC
GACTCTTTGAAATGTCGTT -> ACTCTTTGAAATGTCGTTT
AACTCTGGGTGAGGCGTGT -> ACTCTGGGTGAGGCGTGTT
ATGGCCCGGTTACCACGCA -> TGGCCCGGTTACCACGCAC
GGTTACCACGCACGATGCG -> GTTACCACGCACGATGCGG
CCCCTCGGGCGCTTCGTGG -> CCCTCGGGCGCTTCGTGGA
TGCTGAGGCCGAATAGCGA -> GCTGAGGCCGAATAGCGAC
CAGTTGGTTGCCGATTCCG -> AGTTGGTTGCCGATTCCGT
CATACGGCTCCGACGGGCA -> ATACGGCTCCGACGGGCAG
TTACGCCGTATACGTCGAG -> TACGCCGTATACGTCGAGA
CGAAAGTTACCCTAAGATA -> GAAAGTTACCCTAAGATAA
ATTGCTTATGCGAGGTATA -> TTGCTTATGCGAGGTATAA
GCCTACTAAGCCTGGACCG -> CCTACTAAGCCTGGACCGT
GTTGTTCCCGAAAGTTACC -> TTGTTCCCGAAAGTTACCC
AGCTGCCGGAATTTACTCT -> GCTGCCGGAATTTACTCTA
ACAATGAGCCCCGGCCTGT -> CAATGAGCCCCGGCCTGTC
ATGGGAGCCCTTATCGAGT -> TGGGAGCCCTTATCGAGTG
CTGTATACAGTTGGTTGCC -> TGTATACAGTTGGTTGCCG
CTTTAAATCTCAGACCCCT -> TTTAAATCTCAGACCCCTC
CTGCGCAACAAGGGGTTTT -> TGCGCAACAAGGGGTTTTG
CGCACTTAGGATGAACTCT -> GCACTTAGGATGAACTCTG
ATGGCCGGCTGTGCGTGGA -> TGGCCGGCTGTGCGTGGAC
CCTGTCGAGACTCTCCACG -> CTGTCGAGACTCTCCACGA
CCTGGGGCTTCTAGTCCGC -> CTGGGGCTTCTAGTCCGCG
TCGCGCTCTACAGTCAACT -> CGCGCTCTACAGTCAACTG
ACATGTAAAATGCTGGTTT -> CATGTAAAATGCTGGTTTC
CAAGAAATCTGCCTCCTAC -> AAGAAATCTGCCTCCTACC
ACAGTCAACTGCGCAACAA -> CAGTCAACTGCGCAACAAG
GCCGGAATTTACTCTATAA -> CCGGAATTTACTCTATAAA
ATGTGGGCCGCCTCCCAGG -> TGTGGGCCGCCTCCCAGGG
GCATCACAATAGCGCTGAT -> CATCACAATAGCGCTGATT
CAACTGCGCAACAAGGGGT -> AACTGCGCAACAAGGGGTT
CTGTATGCCGGCTGTTGTT -> TGTATGCCGGCTGTTGTTG
CTGATTGTTGCTTACCGGC -> TGATTGTTGCTTACCGGCC
ACTAATTAAACGCCAATTT -> CTAATTAAACGCCAATTTG
GAAATGTCGTTTTCCTAGA -> AAATGTCGTTTTCCTAGAA
GCAATCCCTTGAACTGTAA -> CAATCCCTTGAACTGTAAG
CGGCCTGTCGAGACTCTCC -> GGCCTGTCGAGACTCTCCA
GATGTCATATTCGTATGGC -> ATGTCATATTCGTATGGCC
GAGTGGCTCACCGTAGACT -> AGTGGCTCACCGTAGACTC
TGGTTCGTTTTCCTAGAAA -> GGTTCGTTTTCCTAGAAAA
CCAAATGTGAGCGCGGAGC -> CAAATGTGAGCGCGGAGCC
CTAAAAAGCAATCCCTTGA -> TAAAAAGCAATCCCTTGAA
TAGAGAACTTTCGAGTAAT -> AGAGAACTTTCGAGTAATA
CCCAGCTGCCGGAATTTAC -> CCAGCTGCCGGAATTTACT
ACGGCTCCGACGGGCAGAG -> CGGCTCCGACGGGCAGAGA
TGTGCCAGGCTGTTCTTCA -> GTGCCAGGCTGTTCTTCAC
TGGTAGCGGGAAGTTCGCC -> GGTAGCGGGAAGTTCGCCT
AAACCAGATTCGACAGTCC -> AACCAGATTCGACAGTCCG
TTAGCAGAATACTATGTGG -> TAGCAGAATACTATGTGGG
CTCCTCCTTATATCTTGTA -> TCCTCCTTATATCTTGTAG
GACTCGTGACACGGTGTAC -> ACTCGTGACACGGTGTACA
ATAGAGGTCGTCAGCTGGT -> TAGAGGTCGTCAGCTGGTG
GTGTTTCATGAATCAACAA -> TGTTTCATGAATCAACAAA
GCTGTTCTTCACCATATCA -> CTGTTCTTCACCATATCAC
TGGGTGAGGCGTGTTGGCT -> GGGTGAGGCGTGTTGGCTC
ACGATGCGGGAATGCTGGG -> CGATGCGGGAATGCTGGGT
GCCGTTTCCATGTGGGCGA -> CCGTTTCCATGTGGGCGAA
GTTATGGTCCTTTAAATCT -> TTATGGTCCTTTAAATCTC
CTTTGCCGGGAGCCCCCGT -> TTTGCCGGGAGCCCCCGTC
TGTCAGGCCTGAGCTACAC -> GTCAGGCCTGAGCTACACG
CAAACCGTATGTATAGCTT -> AAACCGTATGTATAGCTTC
GTCAGGCCTGAGCTACACG -> TCAGGCCTGAGCTACACGA
GGCCGCCAAGAAATCTGCC -> GCCGCCAAGAAATCTGCCT
ATTAGGGGTCAAACCCAGT -> TTAGGGGTCAAACCCAGTA
TCCCTTGAACTGTAAGGCC -> CCCTTGAACTGTAAGGCCT
TCCTTTAAATCTCAGACCC -> CCTTTAAATCTCAGACCCC
AATGGCTGGCTTCAGACCC -> ATGGCTGGCTTCAGACCCT
GGTAAAGAAAAGAAGGGTA -> GTAAAGAAAAGAAGGGTAT
CAATAGCGCTGATTGTTGC -> AATAGCGCTGATTGTTGCT
TAAATTCAGCAGCCGTAGG -> AAATTCAGCAGCCGTAGGG
TGTGACACAGGGCGTCTTG -> GTGACACAGGGCGTCTTGG
GCTGCAAACGCTTTGATCC -> CTGCAAACGCTTTGATCCG
GGAGCCATGTGACACAGGG -> GAGCCATGTGACACAGGGC
GGGGTACTCGATTAAAGGT -> GGGTACTCGATTAAAGGTC
CAATTCCCAGCTGCCGGAA -> AATTCCCAGCTGCCGGAAT
TATTGCTTATGCGAGGTAT -> ATTGCTTATGCGAGGTATA
GTCGAGACTCTGCCAGGGA -> TCGAGACTCTGCCAGGGAA
GGCCATGCCTACTAAGCCT -> GCCATGCCTACTAAGCCTG
GGAATTTACTCTATAAAAG -> GAATTTACTCTATAAAAGA
GAGCAGAACCCAAATGTGA -> AGCAGAACCCAAATGTGAG
TGAACCCACCTCCAGGATG -> GAACCCACCTCCAGGATGT
CTTATCACAAAAATTCGAG -> TTATCACAAAAATTCGAGC
GCTGATGAAGTGCCTTAGT -> CTGATGAAGTGCCTTAGTA
CACAGGGCGTCTTGGCCGT -> ACAGGGCGTCTTGGCCGTT
AAGTGTACTTATGGTAGCG -> AGTGTACTTATGGTAGCGG
GTTTCCATGTGGGCGAAGA -> TTTCCATGTGGGCGAAGAT
TATGTTTGTCCTTAAATAC -> ATGTTTGTCCTTAAATACG
GGTAGGATCACAATTCCCA -> GTAGGATCACAATTCCCAG
GTTTTTCCTAGAAAAAAAT -> TTTTTCCTAGAAAAAAATA
GTATCGTCTCCTCCTTATA -> TATCGTCTCCTCCTTATAT
CCGATCCGTACTCTTACAG -> CGATCCGTACTCTTACAGA
GACACGGTGTACAATGAGC -> ACACGGTGTACAATGAGCC
GCCCCCGTCGACAAACAAG -> CCCCCGTCGACAAACAAGC