30 100
ATAGGCGGAAACTAGTAAGTTGCTTCGACC|CCACCCGACCTGTGGAGAAGTGGCCAATCC
TACCGCAGTGCCCCTCATGATAGGCGGAAA|CTCATGATAGGCGGAAACTAGTGGCGGAAA
GACCAGGATTACGTCGAGTCAGTGCCCCTC|CGTTCGCATATCGTTTCGCAGAGGGTGCGG
AGGTGGTATCTTGAGAAACGGACTGGGGGT|AGCTTAGATCACTGAAACCATTTCACTTGT
AGGCGGAAACTAGTTCAGTTCGAATTCAGT|GCGGGTCTCTTCCATTCGAGCACAGCCCAG
TGCAGTGCCCCTCATGATAGGCGGAAACTA|GTGCCCGTTTTCCACAATCCGTCTAAACCG
AAGAGCGACAGTGCCCCTCATGATAGGCGG|TAGGTTGACAACGCCGACAAGGACGCGGGT
CCACAATCCGTCTAAACCGATCTACTACTA|CCCCTCATGATAGGCGGAAACTAGTGGGAG
GAAACGGACTGGGGGTAGGTTGACAACGCC|AAACCATTTCACTTGTCTAAGATTAGCCTA
CATGATAGGCGGAAACTAGTGTATCTTTTG|GACCCAGTTGGAACGTTGGTTTTGGTCCCG
CCCTCATGATAGGCGGCAGTGCCCCTCATG|CGGGAAAGTGCTTACCGAAAAATTCCAAGC
GTTCCTCTAGGCTGAAAGACGGCGAGACCG|AGTGCCCCTCATGATAGGCGGAAACTAGTG
GTACAGTGCCCCTCATGATAGGCGGAAACT|ACAGTGCAGTGCCCCTCATGATAGGCGGAA
AGTGGCGGAAACTAGTTGTACAGTGCCCCT|GTTGCTCTAAAGGCCAGACAGTGCAGTGCC
AGGATTACGTCGAGTCAGTGCCCCTCATGA|CGCATATCGTTTCGCAGAGGGTGCGGGAGC
TCATGATAGGCGGAAACTAGTTCAGTTCGA|CAAGGACGCGGGTCTCTTCCATTCGAGCAC
TAAACCGATCTACTACTAGCATCTCCGCAA|GGCGGAAACTAGTGGGAGGCGTAGTGCAGA
CAAGCTGTCCTGTCTTAGAGAAGAGCGACA|CTTGAGAAACGGACTGGGGGTAGGTTGACA
AGATTAGCCTAAAATCCACCCCTGCGAAAA|GACTGTATGGGCAGTGCCCCTCATGATAGG
TTAGATCACTGAAACCATTTCACTTGTCTA|CTAACTATACGGTTTCTATTCGTGGCGAGA
CGACGCTCAGAGGCTCAAAGTTCTGACCCA|CTAGGTCGCATCTTAGGGATGCGAGACGAA
AAAAGGCGAGGGAAGGCTCAGTGCCCCTCA|GCGACACTGGAATCTATGCCTAGACGGGAA
CCCGTGGGGCCACCCTAACTATACGGTTTC|CCGCACAGCCCACGCTACCGCAGTGCCCCT
GTTGTACAGTGCCCCTCATGATAGGCGGAA|CAGACAGTGCAGTGCCCCTCATGATAGGCG
TAGTAAACTAGTGATAGCCGGATGGTAGAG|GAGAAGAGCGACAGTGCCCCTCATGATAGG
CCCCTCATGATAGGCGGAAACTAGTAAACT|ATTCCAAGCTGTCCTGTCTTAGAGAAGAGC
ACACTGGAATCTATGCCTAGACGGGAAAGT|ATAGGCGGAAACTAGTGAGTAATTCCTCGA
GGCGGAAACTAGTTGTACAGTGCCCCTCAT|GCTCTAAAGGCCAGACAGTGCAGTGCCCCT
ACAGCCCAGCTGTCTTTTTGCCCAATCAGT|GATACAATCGCGTGTAAACGCTCTTCTGTA
CCCGGAACTATTCCTTAGGTACCGCACAGC|CATTCTGACTCCAGTGCCCCTCATGATACA
TCATGATAGGCGGAAACTAGTAAAAAGGCG|TCAAAAGAACTCAATTACTTTCGCGACACT
TGGCCAATCCTTCGACGGAACATTCTGACT|AGTGCCCCTCATGATAGGCGGAAACTAGTT
GTAACCAGATCCCACCAACCCGTGGGGCCA|GGAACTATTCCTTAGGTACCGCACAGCCCA
CATGATAGGCGGAAACTAGTTCAGTTCGAA|AAGGACGCGGGTCTCTTCCATTCGAGCACA
AAACCGATCTACTACTAGCATCTCCGCAAG|GCGGAAACTAGTGGGAGGCGTAGTGCAGAG
AACTAGTAAAAAGGCGAGGGAAGGCTCAGT|TTACTTTCGCGACACTGGAATCTATGCCTA
CCGGTGGATATGGTTGCTCTAAAGGCCAGA|GTGTATCTTTTGTTCTATCATGAAAATAGA
GTCCCCTCATGATAGGCGGAAACTAGTGAG|ATCTACTACTAGCATCTCCGCAAGTCGACG
CCAGTTGGAACGTTGGTTTTGGTCCCGACA|GAAGATCTGTAACAGCACAGGAAGTCGGAC
CGGAAACTAGTTCAGTTCGAATTCAGTGCC|GGTCTCTTCCATTCGAGCACAGCCCAGCTG
GCTGTCTTTTTGCCCAATCAGTCAGCTGTT|CGCGTGTAAACGCTCTTCTGTAACCAGATC
GAGTCAGTGCCCCTCATGATAGGCGGAAAC|TCGCAGAGGGTGCGGGAGCTCCCGGGGACG
GATAGGCGGAAACTAGTTCAGTTCGAATTC|GACGCGGGTCTCTTCCATTCGAGCACAGCC
CATGATAGGCGGAAACTAGTCCCCTCATGA|CACAATCCGTCTAAACCGATCTACTACTAG
GTGCGTCAGTGCCCCTCATGATAGGCGGAA|CTAGTCCCCTCATGATAGGCGGAAACTAGT
AGGTTGACAACGCCGACAAGGACGCGGGTC|CTAAGATTAGCCTAAAATCCACCCCTGCGA
TCATGAAAATAGATATGTGCCCGTTTTCCA|ATCGACCAGGATTACGTCGAGTCAGTGCCC
GCATCTCCGCAAGTCGACGCTCAGAGGCTC|GCGTAGTGCAGAGCCTAGGTCGCATCTTAG
AAGTGCTTACCGAAAAATTCCAAGCTGTCC|TCGAGGCAGCTAGGTGGTATCTTGAGAAAC
AACTAGTAAGTTGCTTCGACCAGACCGGGC|CTGTGGAGAAGTGGCCAATCCTTCGACGGA
ATTCCTCGAGGCAGCTAGGTGGTATCTTGA|GTCCTTCCTCCGCCGAAGCTTAGATCACTG
AGGCGAGGGAAGGCTCAGTGCCCCTCATGA|ACACTGGAATCTATGCCTAGACGGGAAAGT
TGATAGGCGGAAACTAGTTAGGCAGAACTG|CTAGTGGCGGAAACTAGTTGTACAGTGCCC
GGCCAGACAGTGCAGTGCCCCTCATGATAG|AAATAGATATGTGCCCGTTTTCCACAATCC
TCGTGGAACCGTCAAAAGAACTCAATTACT|GGAAACTAGTTCAGTTCGAATTCAGTGCCC
TCACTTGTCTAAGATTAGCCTAAAATCCAC|TCGTGGCGAGAGACTGTATGGGCAGTGCCC
TCATGATAGGCGGAAACTAGTGAGCCCAAA|TACTAGCATCTCCGCAAGTCGACGCTCAGA
TCTGACCCAGTTGGAACGTTGGTTTTGGTC|CGAGACGAAGATCTGTAACAGCACAGGAAG
TGAGCCCAAATATCAGTGCCCCTCATGATA|GACGCTCAGAGGCTCAAAGTTCTGACCCAG
ACCGATCTACTACTAGCATCTCCGCAAGTC|GGAAACTAGTGGGAGGCGTAGTGCAGAGCC
ACTAGTGCGTCAGTGCCCCTCATGATAGGC|GAAACTAGTCCCCTCATGATAGGCGGAAAC
TCAGAGGCTCAAAGTTCTGACCCAGTTGGA|CGCATCTTAGGGATGCGAGACGAAGATCTG
CATTTCACTTGTCTAAGATTAGCCTAAAAT|CTATTCGTGGCGAGAGACTGTATGGGCAGT
AGCACAGCCCAGCTGTCTTTTTGCCCAATC|TGCGATACAATCGCGTGTAAACGCTCTTCT
TGATAGGCGGAAACTAGTAAACTAGTGATA|GCTGTCCTGTCTTAGAGAAGAGCGACAGTG
ATGATACAGTGCCCCTCATGATAGGCGGAA|CTAGGCTGAAAGACGGCGAGACCGGTGGAT
GATACAATCGCGTGTAAACGCTCTTCTGTA|AAGTTGCTTCGACCAGACCGGGCACCCGGA
ACGGACTGGGGGTAGGTTGACAACGCCGAC|CCATTTCACTTGTCTAAGATTAGCCTAAAA
AGCTGTCCTGTCTTAGAGAAGAGCGACAGT|TGAGAAACGGACTGGGGGTAGGTTGACAAC
AGACGGGAAAGTGCTTACCGAAAAATTCCA|GTAATTCCTCGAGGCAGCTAGGTGGTATCT
CTTCGACCAGACCGGGCACCCGGAACTATT|GCCAATCCTTCGACGGAACATTCTGACTCC
GATAGGCGGAAACTAGTGAGTAATTCCTCG|TGCCCAATCAGTCAGCTGTTAGGTCCTTCC
GTAAAAAGGCGAGGGAAGGCTCAGTGCCCC|TTCGCGACACTGGAATCTATGCCTAGACGG
TGTATGGGCAGTGCCCCTCATGATAGGCGG|AGTTAGGCAGAACTGGAACTTCCCACCCGA
GCTCTTCTGTAACCAGATCCCACCAACCCG|GGGCACCCGGAACTATTCCTTAGGTACCGC
AGGCGGAAACTAGTCCCCTCATGATAGGCG|CCGTCTAAACCGATCTACTACTAGCATCTC
TTTTGCCCAATCAGTCAGCTGTTAGGTCCT|AAACGCTCTTCTGTAACCAGATCCCACCAA
ACAAGGACGCGGGTCTCTTCCATTCGAGCA|AATCCACCCCTGCGAAAACGCCCCGTTGCG
GAAACTAGTAAAAAGGCGAGGGAAGGCTCA|AATTACTTTCGCGACACTGGAATCTATGCC
TGGGGGTAGGTTGACAACGCCGACAAGGAC|CACTTGTCTAAGATTAGCCTAAAATCCACC
CCGAAAAATTCCAAGCTGTCCTGTCTTAGA|CTAGGTGGTATCTTGAGAAACGGACTGGGG
ACACGATCGACCAGGATTACGTCGAGTCAG|GACGATCTCGTTCGCATATCGTTTCGCAGA
GGCCAATCCTTCGACGGAACATTCTGACTC|GTGCCCCTCATGATAGGCGGAAACTAGTTG
AAGGCGAGGGAAGGCTCAGTGCCCCTCATG|GACACTGGAATCTATGCCTAGACGGGAAAG
ATGATAGGCGGAAACTAGTAAACTAGTGAT|AGCTGTCCTGTCTTAGAGAAGAGCGACAGT
CTGTTAGGTCCTTCCTCCGCCGAAGCTTAG|AGATCCCACCAACCCGTGGGGCCACCCTAA
GCAGTGCCCCTCATGATAGGCGGAAACTAG|CAGAACTGGAACTTCCCACCCGACCTGTGG
CGAGACCGGTGGATATGGTTGCTCTAAAGG|AACTAGTGTATCTTTTGTTCTATCATGAAA
TGCCCCTCATGATAGGCGGAAACTAGTGAG|GCTGTCTTTTTGCCCAATCAGTCAGCTGTT
ATCTTTTGTTCTATCATGAAAATAGATATG|TGGTCCCGACACGATCGACCAGGATTACGT
CCATTCGAGCACAGCCCAGCTGTCTTTTTG|GCCCCGTTGCGATACAATCGCGTGTAAACG
TCGACCAGGATTACGTCGAGTCAGTGCCCC|CTCGTTCGCATATCGTTTCGCAGAGGGTGC
ATATCAGTGCCCCTCATGATAGGCGGAAAC|AGGCTCAAAGTTCTGACCCAGTTGGAACGT
GGCTGAAAGACGGCGAGACCGGTGGATATG|CATGATAGGCGGAAACTAGTGTATCTTTTG
AAACTAGTAAAAAGGCGAGGGAAGGCTCAG|ATTACTTTCGCGACACTGGAATCTATGCCT
CCTAACTATACGGTTTCTATTCGTGGCGAG|GCTACCGCAGTGCCCCTCATGATAGGCGGA
TCCATTCGAGCACAGCCCAGCTGTCTTTTT|CGCCCCGTTGCGATACAATCGCGTGTAAAC
GCGGAAACTAGTTGTACAGTGCCCCTCATG|CTCTAAAGGCCAGACAGTGCAGTGCCCCTC
CAGGATTACGTCGAGTCAGTGCCCCTCATG|TCGCATATCGTTTCGCAGAGGGTGCGGGAG
GGAATCTATGCCTAGACGGGAAAGTGCTTA|CGGAAACTAGTGAGTAATTCCTCGAGGCAG
TTCGACCAGACCGGGCACCCGGAACTATTC|CCAATCCTTCGACGGAACATTCTGACTCCA
CGGAAACTAGTAAGTTGCTTCGACCAGACC|CGACCTGTGGAGAAGTGGCCAATCCTTCGA
CTAGTAAAAAGGCGAGGGAAGGCTCAGTGC|ACTTTCGCGACACTGGAATCTATGCCTAGA
AGCCTAAAATCCACCCCTGCGAAAACGCCC|TATGGGCAGTGCCCCTCATGATAGGCGGAA
GCCGGATGGTAGAGATCGTGGAACCGTCAA|CCCCTCATGATAGGCGGAAACTAGTTCAGT
GAACTGGAACTTCCCACCCGACCTGTGGAG|GTGCCCCTCATGATAGGCGGAAACTAGTGC
CCTCATGATAGGCGGAAACTAGTAAGTTGC|GAACTTCCCACCCGACCTGTGGAGAAGTGG
CCCTCATGATAGGCGGAAACTAGTCCCCTC|TTTCCACAATCCGTCTAAACCGATCTACTA
TTTGTTCTATCATGAAAATAGATATGTGCC|CCCGACACGATCGACCAGGATTACGTCGAG
TGCGTCAGTGCCCCTCATGATAGGCGGAAA|TAGTCCCCTCATGATAGGCGGAAACTAGTG
GCCCGTTTTCCACAATCCGTCTAAACCGAT|GAGTCAGTGCCCCTCATGATAGGCGGAAAC
CCAAATATCAGTGCCCCTCATGATAGGCGG|TCAGAGGCTCAAAGTTCTGACCCAGTTGGA
CCACGCTACCGCAGTGCCCCTCATGATAGG|GTGCCCCTCATGATAGGCGGAAACTAGTGG
TTCTGACCCAGTTGGAACGTTGGTTTTGGT|GCGAGACGAAGATCTGTAACAGCACAGGAA
ATAGGCGGAAACTAGTGAGCCCAAATATCA|GCATCTCCGCAAGTCGACGCTCAGAGGCTC
TAATTCCTCGAGGCAGCTAGGTGGTATCTT|AGGTCCTTCCTCCGCCGAAGCTTAGATCAC
GTGCCCCTCATGATAGGCGGAAACTAGTCC|CCGTTTTCCACAATCCGTCTAAACCGATCT
GGCGGAAACTAGTTAGGCAGAACTGGAACT|GGCGGAAACTAGTTGTACAGTGCCCCTCAT
CTTCCTCCGCCGAAGCTTAGATCACTGAAA|AACCCGTGGGGCCACCCTAACTATACGGTT
GCCGACAAGGACGCGGGTCTCTTCCATTCG|CTAAAATCCACCCCTGCGAAAACGCCCCGT
AACTAGTTGCGAAGGTTCCTCTAGGCTGAA|TGAGCCCAAATATCAGTGCCCCTCATGATA
CCTGTCTTAGAGAAGAGCGACAGTGCCCCT|ACGGACTGGGGGTAGGTTGACAACGCCGAC
AAACTAGTTGCGAAGGTTCCTCTAGGCTGA|GTGAGCCCAAATATCAGTGCCCCTCATGAT
GCAGCTAGGTGGTATCTTGAGAAACGGACT|CGCCGAAGCTTAGATCACTGAAACCATTTC
CCCCTCATGATAGGCGGAAACTAGTTCAGT|CCGACAAGGACGCGGGTCTCTTCCATTCGA
AAGGTTCCTCTAGGCTGAAAGACGGCGAGA|ATCAGTGCCCCTCATGATAGGCGGAAACTA
AGACGGCGAGACCGGTGGATATGGTTGCTC|GGCGGAAACTAGTGTATCTTTTGTTCTATC
CAAATATCAGTGCCCCTCATGATAGGCGGA|CAGAGGCTCAAAGTTCTGACCCAGTTGGAA
CTCGAGGCAGCTAGGTGGTATCTTGAGAAA|TTCCTCCGCCGAAGCTTAGATCACTGAAAC
TGCCCCTCATGATAGGCGGAAACTAGTGCG|CAGTGCCCCTCATGATAGGCGGAAACTAGT
CTTCGACGGAACATTCTGACTCCAGTGCCC|CATGATAGGCGGAAACTAGTTGCGAAGGTT
GACTCCAGTGCCCCTCATGATACAGTGCCC|AGTTGCGAAGGTTCCTCTAGGCTGAAAGAC
ATACAATCGCGTGTAAACGCTCTTCTGTAA|AGTTGCTTCGACCAGACCGGGCACCCGGAA
AAGGCCAGACAGTGCAGTGCCCCTCATGAT|GAAAATAGATATGTGCCCGTTTTCCACAAT
AGTGAGCCCAAATATCAGTGCCCCTCATGA|TCGACGCTCAGAGGCTCAAAGTTCTGACCC
TAAGATTAGCCTAAAATCCACCCCTGCGAA|GAGACTGTATGGGCAGTGCCCCTCATGATA
GATAGGCGGAAACTAGTTGCGAAGGTTCCT|CGGAAACTAGTGAGCCCAAATATCAGTGCC
TCGCGTGTAAACGCTCTTCTGTAACCAGAT|TTCGACCAGACCGGGCACCCGGAACTATTC
GATCACTGAAACCATTTCACTTGTCTAAGA|ACTATACGGTTTCTATTCGTGGCGAGAGAC
AGCATCTCCGCAAGTCGACGCTCAGAGGCT|GGCGTAGTGCAGAGCCTAGGTCGCATCTTA
ATAGGCGGAAACTAGTGTATCTTTTGTTCT|CAGTTGGAACGTTGGTTTTGGTCCCGACAC
GCGTCAGTGCCCCTCATGATAGGCGGAAAC|AGTCCCCTCATGATAGGCGGAAACTAGTGA
AATCCACCCCTGCGAAAACGCCCCGTTGCG|AGTGCCCCTCATGATAGGCGGAAACTAGTA
GATACAGTGCCCCTCATGATAGGCGGAAAC|AGGCTGAAAGACGGCGAGACCGGTGGATAT
AGAGACTGTATGGGCAGTGCCCCTCATGAT|GAAACTAGTTAGGCAGAACTGGAACTTCCC
CAGAGGCTCAAAGTTCTGACCCAGTTGGAA|GCATCTTAGGGATGCGAGACGAAGATCTGT
CTTGTCTAAGATTAGCCTAAAATCCACCCC|TGGCGAGAGACTGTATGGGCAGTGCCCCTC
TATCTTTTGTTCTATCATGAAAATAGATAT|TTGGTCCCGACACGATCGACCAGGATTACG
TATACGGTTTCTATTCGTGGCGAGAGACTG|GCAGTGCCCCTCATGATAGGCGGAAACTAG
TGATAGGCGGCAGTGCCCCTCATGATAGGC|AGTGCTTACCGAAAAATTCCAAGCTGTCCT
GCTCAGAGGCTCAAAGTTCTGACCCAGTTG|GTCGCATCTTAGGGATGCGAGACGAAGATC
GTGAGCCCAAATATCAGTGCCCCTCATGAT|CGACGCTCAGAGGCTCAAAGTTCTGACCCA
GAAACTAGTGAGTAATTCCTCGAGGCAGCT|CAGTCAGCTGTTAGGTCCTTCCTCCGCCGA
TGTACAGTGCCCCTCATGATAGGCGGAAAC|GACAGTGCAGTGCCCCTCATGATAGGCGGA
TGGTAGAGATCGTGGAACCGTCAAAAGAAC|ATGATAGGCGGAAACTAGTTCAGTTCGAAT
GGCAGTGCCCCTCATGATAGGCGGAAACTA|CCGAAAAATTCCAAGCTGTCCTGTCTTAGA
CTAGTGCGTCAGTGCCCCTCATGATAGGCG|AAACTAGTCCCCTCATGATAGGCGGAAACT
GCGGCAGTGCCCCTCATGATAGGCGGAAAC|TACCGAAAAATTCCAAGCTGTCCTGTCTTA
GTATCTTTTGTTCTATCATGAAAATAGATA|TTTGGTCCCGACACGATCGACCAGGATTAC
TCCGCAAGTCGACGCTCAGAGGCTCAAAGT|GTGCAGAGCCTAGGTCGCATCTTAGGGATG
GCGAGAGACTGTATGGGCAGTGCCCCTCAT|GCGGAAACTAGTTAGGCAGAACTGGAACTT
GTCCTGTCTTAGAGAAGAGCGACAGTGCCC|AAACGGACTGGGGGTAGGTTGACAACGCCG
AGTCCCCTCATGATAGGCGGAAACTAGTGA|GATCTACTACTAGCATCTCCGCAAGTCGAC
GAAACTAGTAAGTTGCTTCGACCAGACCGG|ACCTGTGGAGAAGTGGCCAATCCTTCGACG
CTAGTGAGTAATTCCTCGAGGCAGCTAGGT|CAGCTGTTAGGTCCTTCCTCCGCCGAAGCT
GAAGGCTCAGTGCCCCTCATGATAGGCGGC|ATCTATGCCTAGACGGGAAAGTGCTTACCG
AAACTAGTGCGTCAGTGCCCCTCATGATAG|CGGAAACTAGTCCCCTCATGATAGGCGGAA
CATGATAGGCGGCAGTGCCCCTCATGATAG|AAAGTGCTTACCGAAAAATTCCAAGCTGTC
AACGGACTGGGGGTAGGTTGACAACGCCGA|ACCATTTCACTTGTCTAAGATTAGCCTAAA
CTATACGGTTTCTATTCGTGGCGAGAGACT|CGCAGTGCCCCTCATGATAGGCGGAAACTA
CTCAGTGCCCCTCATGATAGGCGGAAACTA|TCGTGGAACCGTCAAAAGAACTCAATTACT
ACCAACCCGTGGGGCCACCCTAACTATACG|AGGTACCGCACAGCCCACGCTACCGCAGTG
CCACCCCTGCGAAAACGCCCCGTTGCGATA|GCCCCTCATGATAGGCGGAAACTAGTAAGT
GAAACTAGTTCAGTTCGAATTCAGTGCCCC|TCTCTTCCATTCGAGCACAGCCCAGCTGTC
GGCAGAACTGGAACTTCCCACCCGACCTGT|TACAGTGCCCCTCATGATAGGCGGAAACTA
CCAGGATTACGTCGAGTCAGTGCCCCTCAT|TTCGCATATCGTTTCGCAGAGGGTGCGGGA
AAACTAGTGAGTAATTCCTCGAGGCAGCTA|AGTCAGCTGTTAGGTCCTTCCTCCGCCGAA
GGAACGTTGGTTTTGGTCCCGACACGATCG|CTGTAACAGCACAGGAAGTCGGACGATCTC
CCGTTGCGATACAATCGCGTGTAAACGCTC|AACTAGTAAGTTGCTTCGACCAGACCGGGC
GCGAAAACGCCCCGTTGCGATACAATCGCG|TGATAGGCGGAAACTAGTAAGTTGCTTCGA
ACCTGTGGAGAAGTGGCCAATCCTTCGACG|AAACTAGTGCGTCAGTGCCCCTCATGATAG
CTAAACCGATCTACTACTAGCATCTCCGCA|AGGCGGAAACTAGTGGGAGGCGTAGTGCAG
CCCCTCATGATAGGCGGAAACTAGTGAGTA|TGTCTTTTTGCCCAATCAGTCAGCTGTTAG
AAAAATTCCAAGCTGTCCTGTCTTAGAGAA|GGTGGTATCTTGAGAAACGGACTGGGGGTA
CCCTCATGATAGGCGGAAACTAGTTGCGAA|TGATAGGCGGAAACTAGTGAGCCCAAATAT
AAAATCCACCCCTGCGAAAACGCCCCGTTG|GCAGTGCCCCTCATGATAGGCGGAAACTAG
AAGAACTCAATTACTTTCGCGACACTGGAA|TCGAATTCAGTGCCCCTCATGATAGGCGGA
AGGCGGCAGTGCCCCTCATGATAGGCGGAA|CTTACCGAAAAATTCCAAGCTGTCCTGTCT
CGAAAAATTCCAAGCTGTCCTGTCTTAGAG|TAGGTGGTATCTTGAGAAACGGACTGGGGG
GGAGAAGTGGCCAATCCTTCGACGGAACAT|GTGCGTCAGTGCCCCTCATGATAGGCGGAA
CTCATGATAGGCGGAAACTAGTGGCGGAAA|GGCGAGACCGGTGGATATGGTTGCTCTAAA
TCTTAGAGAAGAGCGACAGTGCCCCTCATG|ACTGGGGGTAGGTTGACAACGCCGACAAGG
ACTAGTTAGGCAGAACTGGAACTTCCCACC|ACTAGTTGTACAGTGCCCCTCATGATAGGC
GAAACTAGTTAGGCAGAACTGGAACTTCCC|GAAACTAGTTGTACAGTGCCCCTCATGATA
GATAGGCGGAAACTAGTAAACTAGTGATAG|CTGTCCTGTCTTAGAGAAGAGCGACAGTGC
CTCCGCAAGTCGACGCTCAGAGGCTCAAAG|AGTGCAGAGCCTAGGTCGCATCTTAGGGAT
CCCCTCATGATAGGCGGAAACTAGTAAGTT|TGGAACTTCCCACCCGACCTGTGGAGAAGT
GAGGGAAGGCTCAGTGCCCCTCATGATAGG|TGGAATCTATGCCTAGACGGGAAAGTGCTT
AGTGGCCAATCCTTCGACGGAACATTCTGA|TCAGTGCCCCTCATGATAGGCGGAAACTAG
GATATGGTTGCTCTAAAGGCCAGACAGTGC|CTTTTGTTCTATCATGAAAATAGATATGTG
GACGCTCAGAGGCTCAAAGTTCTGACCCAG|TAGGTCGCATCTTAGGGATGCGAGACGAAG
CGACAGTGCCCCTCATGATAGGCGGAAACT|TGACAACGCCGACAAGGACGCGGGTCTCTT
ACCAGATCCCACCAACCCGTGGGGCCACCC|ACTATTCCTTAGGTACCGCACAGCCCACGC
GATAGGCGGCAGTGCCCCTCATGATAGGCG|GTGCTTACCGAAAAATTCCAAGCTGTCCTG
ACTATACGGTTTCTATTCGTGGCGAGAGAC|CCGCAGTGCCCCTCATGATAGGCGGAAACT
CAACGCCGACAAGGACGCGGGTCTCTTCCA|TAGCCTAAAATCCACCCCTGCGAAAACGCC
AGATCCCACCAACCCGTGGGGCCACCCTAA|ATTCCTTAGGTACCGCACAGCCCACGCTAC
GTGTATCTTTTGTTCTATCATGAAAATAGA|GTTTTGGTCCCGACACGATCGACCAGGATT
ATCTATGCCTAGACGGGAAAGTGCTTACCG|AAACTAGTGAGTAATTCCTCGAGGCAGCTA
ATCTCCGCAAGTCGACGCTCAGAGGCTCAA|GTAGTGCAGAGCCTAGGTCGCATCTTAGGG
TCCACCCCTGCGAAAACGCCCCGTTGCGAT|TGCCCCTCATGATAGGCGGAAACTAGTAAG
CTTACCGAAAAATTCCAAGCTGTCCTGTCT|GCAGCTAGGTGGTATCTTGAGAAACGGACT
GATCTACTACTAGCATCTCCGCAAGTCGAC|AACTAGTGGGAGGCGTAGTGCAGAGCCTAG
ATGCCTAGACGGGAAAGTGCTTACCGAAAA|TAGTGAGTAATTCCTCGAGGCAGCTAGGTG
CAGTGCCCCTCATGATAGGCGGAAACTAGT|GTGCAGTGCCCCTCATGATAGGCGGAAACT
GGAAGGCTCAGTGCCCCTCATGATAGGCGG|AATCTATGCCTAGACGGGAAAGTGCTTACC
GAGCCCAAATATCAGTGCCCCTCATGATAG|ACGCTCAGAGGCTCAAAGTTCTGACCCAGT
CGTGGCGAGAGACTGTATGGGCAGTGCCCC|ATAGGCGGAAACTAGTTAGGCAGAACTGGA
TCCCACCCGACCTGTGGAGAAGTGGCCAAT|GATAGGCGGAAACTAGTGCGTCAGTGCCCC
GACCGGTGGATATGGTTGCTCTAAAGGCCA|TAGTGTATCTTTTGTTCTATCATGAAAATA
GCCTAAAATCCACCCCTGCGAAAACGCCCC|ATGGGCAGTGCCCCTCATGATAGGCGGAAA
AACTAGTAAACTAGTGATAGCCGGATGGTA|TTAGAGAAGAGCGACAGTGCCCCTCATGAT
ATACAGTGCCCCTCATGATAGGCGGAAACT|GGCTGAAAGACGGCGAGACCGGTGGATATG
GTTGCGATACAATCGCGTGTAAACGCTCTT|CTAGTAAGTTGCTTCGACCAGACCGGGCAC
CGCTCTTCTGTAACCAGATCCCACCAACCC|CGGGCACCCGGAACTATTCCTTAGGTACCG
CCTCATGATAGGCGGAAACTAGTAAACTAG|TCCAAGCTGTCCTGTCTTAGAGAAGAGCGA
ATTTCACTTGTCTAAGATTAGCCTAAAATC|TATTCGTGGCGAGAGACTGTATGGGCAGTG
CTCAATTACTTTCGCGACACTGGAATCTAT|TTCAGTGCCCCTCATGATAGGCGGAAACTA
TCCCACCAACCCGTGGGGCCACCCTAACTA|CCTTAGGTACCGCACAGCCCACGCTACCGC
CTGGGGGTAGGTTGACAACGCCGACAAGGA|TCACTTGTCTAAGATTAGCCTAAAATCCAC
GAGACTGTATGGGCAGTGCCCCTCATGATA|AAACTAGTTAGGCAGAACTGGAACTTCCCA
CTGTCTTAGAGAAGAGCGACAGTGCCCCTC|CGGACTGGGGGTAGGTTGACAACGCCGACA
AGTGCCCCTCATGATAGGCGGAAACTAGTA|TGGAACCGTCAAAAGAACTCAATTACTTTC
CAATCGCGTGTAAACGCTCTTCTGTAACCA|TGCTTCGACCAGACCGGGCACCCGGAACTA
ATACGGTTTCTATTCGTGGCGAGAGACTGT|CAGTGCCCCTCATGATAGGCGGAAACTAGT
CCTAAAATCCACCCCTGCGAAAACGCCCCG|TGGGCAGTGCCCCTCATGATAGGCGGAAAC
CTCATGATAGGCGGAAACTAGTGAGTAATT|CTTTTTGCCCAATCAGTCAGCTGTTAGGTC
GTACCGCACAGCCCACGCTACCGCAGTGCC|CCTCATGATACAGTGCCCCTCATGATAGGC
CTAGCATCTCCGCAAGTCGACGCTCAGAGG|GAGGCGTAGTGCAGAGCCTAGGTCGCATCT
AGTGCCCCTCATGATAGGCGGCAGTGCCCC|CTAGACGGGAAAGTGCTTACCGAAAAATTC
AAAACGCCCCGTTGCGATACAATCGCGTGT|TAGGCGGAAACTAGTAAGTTGCTTCGACCA
ATCCACCCCTGCGAAAACGCCCCGTTGCGA|GTGCCCCTCATGATAGGCGGAAACTAGTAA
GTAGAGATCGTGGAACCGTCAAAAGAACTC|GATAGGCGGAAACTAGTTCAGTTCGAATTC
CCCACCAACCCGTGGGGCCACCCTAACTAT|CTTAGGTACCGCACAGCCCACGCTACCGCA
AAGACGGCGAGACCGGTGGATATGGTTGCT|AGGCGGAAACTAGTGTATCTTTTGTTCTAT
CATGATAGGCGGAAACTAGTAAACTAGTGA|AAGCTGTCCTGTCTTAGAGAAGAGCGACAG
GGCGGCAGTGCCCCTCATGATAGGCGGAAA|TTACCGAAAAATTCCAAGCTGTCCTGTCTT
TCAGTTCGAATTCAGTGCCCCTCATGATAG|TTCGAGCACAGCCCAGCTGTCTTTTTGCCC
TGGAACTTCCCACCCGACCTGTGGAGAAGT|CCCTCATGATAGGCGGAAACTAGTGCGTCA
GAGAAGAGCGACAGTGCCCCTCATGATAGG|GGGTAGGTTGACAACGCCGACAAGGACGCG
ATAGATATGTGCCCGTTTTCCACAATCCGT|GGATTACGTCGAGTCAGTGCCCCTCATGAT
TTCCATTCGAGCACAGCCCAGCTGTCTTTT|ACGCCCCGTTGCGATACAATCGCGTGTAAA
ATAGGCGGAAACTAGTAAACTAGTGATAGC|TGTCCTGTCTTAGAGAAGAGCGACAGTGCC
AAGTTGCTTCGACCAGACCGGGCACCCGGA|GAAGTGGCCAATCCTTCGACGGAACATTCT
GTCAGCTGTTAGGTCCTTCCTCCGCCGAAG|TAACCAGATCCCACCAACCCGTGGGGCCAC
CACTTGTCTAAGATTAGCCTAAAATCCACC|CGTGGCGAGAGACTGTATGGGCAGTGCCCC
GTGGTATCTTGAGAAACGGACTGGGGGTAG|CTTAGATCACTGAAACCATTTCACTTGTCT
CTTAGAGAAGAGCGACAGTGCCCCTCATGA|CTGGGGGTAGGTTGACAACGCCGACAAGGA
GGGTCTCTTCCATTCGAGCACAGCCCAGCT|TGCGAAAACGCCCCGTTGCGATACAATCGC
ACTCCAGTGCCCCTCATGATACAGTGCCCC|GTTGCGAAGGTTCCTCTAGGCTGAAAGACG
GAGGCAGCTAGGTGGTATCTTGAGAAACGG|CTCCGCCGAAGCTTAGATCACTGAAACCAT
CAGTGCAGTGCCCCTCATGATAGGCGGAAA|TATGTGCCCGTTTTCCACAATCCGTCTAAA
CAGTGCCCCTCATGATAGGCGGAAACTAGT|TGAAAGACGGCGAGACCGGTGGATATGGTT
CTCTTCTGTAACCAGATCCCACCAACCCGT|GGCACCCGGAACTATTCCTTAGGTACCGCA
ATTCCTTAGGTACCGCACAGCCCACGCTAC|TCCAGTGCCCCTCATGATACAGTGCCCCTC
CTCATGATAGGCGGCAGTGCCCCTCATGAT|GGAAAGTGCTTACCGAAAAATTCCAAGCTG
TGCGAAGGTTCCTCTAGGCTGAAAGACGGC|AAATATCAGTGCCCCTCATGATAGGCGGAA
AGTGCCCCTCATGATAGGCGGAAACTAGTG|TGCAGTGCCCCTCATGATAGGCGGAAACTA
GAGCGACAGTGCCCCTCATGATAGGCGGAA|GGTTGACAACGCCGACAAGGACGCGGGTCT
TAAAATCCACCCCTGCGAAAACGCCCCGTT|GGCAGTGCCCCTCATGATAGGCGGAAACTA
GAAAGACGGCGAGACCGGTGGATATGGTTG|ATAGGCGGAAACTAGTGTATCTTTTGTTCT
ACGTCGAGTCAGTGCCCCTCATGATAGGCG|TCGTTTCGCAGAGGGTGCGGGAGCTCCCGG
CAGCTGTTAGGTCCTTCCTCCGCCGAAGCT|ACCAGATCCCACCAACCCGTGGGGCCACCC
CTCATGATAGGCGGAAACTAGTGCGTCAGT|CCCCTCATGATAGGCGGAAACTAGTCCCCT
CTAGGCTGAAAGACGGCGAGACCGGTGGAT|CCTCATGATAGGCGGAAACTAGTGTATCTT
GGTTGACAACGCCGACAAGGACGCGGGTCT|TAAGATTAGCCTAAAATCCACCCCTGCGAA
AACTAGTGATAGCCGGATGGTAGAGATCGT|GAGCGACAGTGCCCCTCATGATAGGCGGAA
ACAGCCCACGCTACCGCAGTGCCCCTCATG|ATACAGTGCCCCTCATGATAGGCGGAAACT
GCGATACAATCGCGTGTAAACGCTCTTCTG|GTAAGTTGCTTCGACCAGACCGGGCACCCG
GGGGTAGGTTGACAACGCCGACAAGGACGC|CTTGTCTAAGATTAGCCTAAAATCCACCCC
CAGTGCCCCTCATGATACAGTGCCCCTCAT|CGAAGGTTCCTCTAGGCTGAAAGACGGCGA
CGGAACATTCTGACTCCAGTGCCCCTCATG|AGGCGGAAACTAGTTGCGAAGGTTCCTCTA
ACGCCCCGTTGCGATACAATCGCGTGTAAA|GCGGAAACTAGTAAGTTGCTTCGACCAGAC
GTGGCGGAAACTAGTTGTACAGTGCCCCTC|TTGCTCTAAAGGCCAGACAGTGCAGTGCCC
CTACTAGCATCTCCGCAAGTCGACGCTCAG|TGGGAGGCGTAGTGCAGAGCCTAGGTCGCA
CCTCATGATAGGCGGAAACTAGTGAGTAAT|TCTTTTTGCCCAATCAGTCAGCTGTTAGGT
CGTCGAGTCAGTGCCCCTCATGATAGGCGG|CGTTTCGCAGAGGGTGCGGGAGCTCCCGGG
AACTAGTGTATCTTTTGTTCTATCATGAAA|CGTTGGTTTTGGTCCCGACACGATCGACCA
CCGCAGTGCCCCTCATGATAGGCGGAAACT|CATGATAGGCGGAAACTAGTGGCGGAAACT
AGGCGGAAACTAGTTGCGAAGGTTCCTCTA|AAACTAGTGAGCCCAAATATCAGTGCCCCT
CGCGACACTGGAATCTATGCCTAGACGGGA|CATGATAGGCGGAAACTAGTGAGTAATTCC
GGGAAAGTGCTTACCGAAAAATTCCAAGCT|TTCCTCGAGGCAGCTAGGTGGTATCTTGAG
CGACGGAACATTCTGACTCCAGTGCCCCTC|GATAGGCGGAAACTAGTTGCGAAGGTTCCT
TAGGCGGAAACTAGTTAGGCAGAACTGGAA|GTGGCGGAAACTAGTTGTACAGTGCCCCTC
GATCGACCAGGATTACGTCGAGTCAGTGCC|ATCTCGTTCGCATATCGTTTCGCAGAGGGT
GGAAACTAGTAAACTAGTGATAGCCGGATG|GTCTTAGAGAAGAGCGACAGTGCCCCTCAT
ACTGTATGGGCAGTGCCCCTCATGATAGGC|CTAGTTAGGCAGAACTGGAACTTCCCACCC
TTGCTCTAAAGGCCAGACAGTGCAGTGCCC|TCTATCATGAAAATAGATATGTGCCCGTTT
ATGATAGGCGGAAACTAGTGAGCCCAAATA|CTAGCATCTCCGCAAGTCGACGCTCAGAGG
AAACTAGTTAGGCAGAACTGGAACTTCCCA|AAACTAGTTGTACAGTGCCCCTCATGATAG
CGGAAACTAGTTAGGCAGAACTGGAACTTC|CGGAAACTAGTTGTACAGTGCCCCTCATGA
CAATCCTTCGACGGAACATTCTGACTCCAG|CCCCTCATGATAGGCGGAAACTAGTTGCGA
ATGGTAGAGATCGTGGAACCGTCAAAAGAA|CATGATAGGCGGAAACTAGTTCAGTTCGAA
GCCCCTCATGATAGGCGGAAACTAGTTCAG|GCCGACAAGGACGCGGGTCTCTTCCATTCG
AAACGCCCCGTTGCGATACAATCGCGTGTA|AGGCGGAAACTAGTAAGTTGCTTCGACCAG
AACGCCCCGTTGCGATACAATCGCGTGTAA|GGCGGAAACTAGTAAGTTGCTTCGACCAGA
CACAGCCCAGCTGTCTTTTTGCCCAATCAG|CGATACAATCGCGTGTAAACGCTCTTCTGT
CTTTCGCGACACTGGAATCTATGCCTAGAC|CCCTCATGATAGGCGGAAACTAGTGAGTAA
CATGATAGGCGGAAACTAGTAAGTTGCTTC|CTTCCCACCCGACCTGTGGAGAAGTGGCCA
CATGATAGGCGGAAACTAGTAAAAAGGCGA|CAAAAGAACTCAATTACTTTCGCGACACTG
TAGTCCCCTCATGATAGGCGGAAACTAGTG|CGATCTACTACTAGCATCTCCGCAAGTCGA
GAAAATAGATATGTGCCCGTTTTCCACAAT|ACCAGGATTACGTCGAGTCAGTGCCCCTCA
AGTCGACGCTCAGAGGCTCAAAGTTCTGAC|AGCCTAGGTCGCATCTTAGGGATGCGAGAC
GTGGCGAGAGACTGTATGGGCAGTGCCCCT|TAGGCGGAAACTAGTTAGGCAGAACTGGAA
GGTTGCTCTAAAGGCCAGACAGTGCAGTGC|GTTCTATCATGAAAATAGATATGTGCCCGT
TTCTGTAACCAGATCCCACCAACCCGTGGG|ACCCGGAACTATTCCTTAGGTACCGCACAG
GCGAGACCGGTGGATATGGTTGCTCTAAAG|AAACTAGTGTATCTTTTGTTCTATCATGAA
GAAACCATTTCACTTGTCTAAGATTAGCCT|GGTTTCTATTCGTGGCGAGAGACTGTATGG
ACTAGTCCCCTCATGATAGGCGGAAACTAG|ACCGATCTACTACTAGCATCTCCGCAAGTC
GTGTAAACGCTCTTCTGTAACCAGATCCCA|ACCAGACCGGGCACCCGGAACTATTCCTTA
TCAGTGCCCCTCATGATAGGCGGAAACTAG|CCCCTCATGATAGGCGGAAACTAGTGAGCC
GTCTTTTTGCCCAATCAGTCAGCTGTTAGG|GTGTAAACGCTCTTCTGTAACCAGATCCCA
TAGAGAAGAGCGACAGTGCCCCTCATGATA|GGGGGTAGGTTGACAACGCCGACAAGGACG
AGTGCTTACCGAAAAATTCCAAGCTGTCCT|CGAGGCAGCTAGGTGGTATCTTGAGAAACG
GACGGCGAGACCGGTGGATATGGTTGCTCT|GCGGAAACTAGTGTATCTTTTGTTCTATCA
TGCCCCTCATGATAGGCGGAAACTAGTTGC|TCATGATAGGCGGAAACTAGTGAGCCCAAA
CTAGTGTATCTTTTGTTCTATCATGAAAAT|TTGGTTTTGGTCCCGACACGATCGACCAGG
TTTCCACAATCCGTCTAAACCGATCTACTA|GTGCCCCTCATGATAGGCGGAAACTAGTGG
ATTAGCCTAAAATCCACCCCTGCGAAAACG|CTGTATGGGCAGTGCCCCTCATGATAGGCG
GCCAATCCTTCGACGGAACATTCTGACTCC|TGCCCCTCATGATAGGCGGAAACTAGTTGC
ATCGTGGAACCGTCAAAAGAACTCAATTAC|CGGAAACTAGTTCAGTTCGAATTCAGTGCC
TCATGATACAGTGCCCCTCATGATAGGCGG|CTCTAGGCTGAAAGACGGCGAGACCGGTGG
CGGGTCTCTTCCATTCGAGCACAGCCCAGC|CTGCGAAAACGCCCCGTTGCGATACAATCG
CATGATAGGCGGAAACTAGTGAGCCCAAAT|ACTAGCATCTCCGCAAGTCGACGCTCAGAG
GGCGAGACCGGTGGATATGGTTGCTCTAAA|GAAACTAGTGTATCTTTTGTTCTATCATGA
TGTAACCAGATCCCACCAACCCGTGGGGCC|CGGAACTATTCCTTAGGTACCGCACAGCCC
CCTCATGATAGGCGGCAGTGCCCCTCATGA|GGGAAAGTGCTTACCGAAAAATTCCAAGCT
GAAAGTGCTTACCGAAAAATTCCAAGCTGT|CCTCGAGGCAGCTAGGTGGTATCTTGAGAA
AACCGATCTACTACTAGCATCTCCGCAAGT|CGGAAACTAGTGGGAGGCGTAGTGCAGAGC
TCAGCTGTTAGGTCCTTCCTCCGCCGAAGC|AACCAGATCCCACCAACCCGTGGGGCCACC
CAGCCCAGCTGTCTTTTTGCCCAATCAGTC|ATACAATCGCGTGTAAACGCTCTTCTGTAA
CGCTCAGAGGCTCAAAGTTCTGACCCAGTT|GGTCGCATCTTAGGGATGCGAGACGAAGAT
TAGTGAGCCCAAATATCAGTGCCCCTCATG|GTCGACGCTCAGAGGCTCAAAGTTCTGACC
GCCCCTCATGATAGGCGGCAGTGCCCCTCA|GACGGGAAAGTGCTTACCGAAAAATTCCAA
AAATTCCAAGCTGTCCTGTCTTAGAGAAGA|TGGTATCTTGAGAAACGGACTGGGGGTAGG
GCGGAAACTAGTGCGTCAGTGCCCCTCATG|TAGGCGGAAACTAGTCCCCTCATGATAGGC
TTGTTCTATCATGAAAATAGATATGTGCCC|CCGACACGATCGACCAGGATTACGTCGAGT
GGCGGAAACTAGTGGCGGAAACTAGTTGTA|GGTGGATATGGTTGCTCTAAAGGCCAGACA
TAGGTTGACAACGCCGACAAGGACGCGGGT|TCTAAGATTAGCCTAAAATCCACCCCTGCG
GGTCTCTTCCATTCGAGCACAGCCCAGCTG|GCGAAAACGCCCCGTTGCGATACAATCGCG
CATGATAGGCGGAAACTAGTTAGGCAGAAC|AACTAGTGGCGGAAACTAGTTGTACAGTGC
TTGAGAAACGGACTGGGGGTAGGTTGACAA|ACTGAAACCATTTCACTTGTCTAAGATTAG
CTATTCGTGGCGAGAGACTGTATGGGCAGT|TCATGATAGGCGGAAACTAGTTAGGCAGAA
TCCACAATCCGTCTAAACCGATCTACTACT|GCCCCTCATGATAGGCGGAAACTAGTGGGA
CAGTGCCCCTCATGATAGGCGGAAACTAGT|CAACGCCGACAAGGACGCGGGTCTCTTCCA
TGGCGGAAACTAGTTGTACAGTGCCCCTCA|TGCTCTAAAGGCCAGACAGTGCAGTGCCCC
CGGCGAGACCGGTGGATATGGTTGCTCTAA|GGAAACTAGTGTATCTTTTGTTCTATCATG
TCATGATAGGCGGAAACTAGTGCGTCAGTG|CCCTCATGATAGGCGGAAACTAGTCCCCTC
CCCAGTTGGAACGTTGGTTTTGGTCCCGAC|CGAAGATCTGTAACAGCACAGGAAGTCGGA
TCGACGCTCAGAGGCTCAAAGTTCTGACCC|CCTAGGTCGCATCTTAGGGATGCGAGACGA
ACAGTGCCCCTCATGATAGGCGGAAACTAG|CTGAAAGACGGCGAGACCGGTGGATATGGT
AACTGGAACTTCCCACCCGACCTGTGGAGA|TGCCCCTCATGATAGGCGGAAACTAGTGCG
TTCAGTGCCCCTCATGATAGGCGGAAACTA|GCCCAGCTGTCTTTTTGCCCAATCAGTCAG
CCCCTCATGATAGGCGGCAGTGCCCCTCAT|ACGGGAAAGTGCTTACCGAAAAATTCCAAG
ATCTACTACTAGCATCTCCGCAAGTCGACG|ACTAGTGGGAGGCGTAGTGCAGAGCCTAGG
CAGTGCCCCTCATGATAGGCGGAAACTAGT|GATAGGCGGAAACTAGTGGCGGAAACTAGT
TAGGCTGAAAGACGGCGAGACCGGTGGATA|CTCATGATAGGCGGAAACTAGTGTATCTTT
GCCCCTCATGATAGGCGGAAACTAGTCCCC|GTTTTCCACAATCCGTCTAAACCGATCTAC
AGGCGGAAACTAGTGGCGGAAACTAGTTGT|CGGTGGATATGGTTGCTCTAAAGGCCAGAC
TGAAAATAGATATGTGCCCGTTTTCCACAA|GACCAGGATTACGTCGAGTCAGTGCCCCTC
CCCAAATATCAGTGCCCCTCATGATAGGCG|CTCAGAGGCTCAAAGTTCTGACCCAGTTGG
TTCCCACCCGACCTGTGGAGAAGTGGCCAA|TGATAGGCGGAAACTAGTGCGTCAGTGCCC
ACTAGCATCTCCGCAAGTCGACGCTCAGAG|GGAGGCGTAGTGCAGAGCCTAGGTCGCATC
CAGTGCCCCTCATGATAGGCGGAAACTAGT|GTGGAACCGTCAAAAGAACTCAATTACTTT
GACGGAACATTCTGACTCCAGTGCCCCTCA|ATAGGCGGAAACTAGTTGCGAAGGTTCCTC
GTTGCTTCGACCAGACCGGGCACCCGGAAC|AGTGGCCAATCCTTCGACGGAACATTCTGA
TTCGAGCACAGCCCAGCTGTCTTTTTGCCC|CCGTTGCGATACAATCGCGTGTAAACGCTC
CCGTCTAAACCGATCTACTACTAGCATCTC|TGATAGGCGGAAACTAGTGGGAGGCGTAGT
CTCATGATAGGCGGAAACTAGTAAGTTGCT|AACTTCCCACCCGACCTGTGGAGAAGTGGC
CGATCGACCAGGATTACGTCGAGTCAGTGC|GATCTCGTTCGCATATCGTTTCGCAGAGGG
CGTGTAAACGCTCTTCTGTAACCAGATCCC|GACCAGACCGGGCACCCGGAACTATTCCTT
TAGTTAGGCAGAACTGGAACTTCCCACCCG|TAGTTGTACAGTGCCCCTCATGATAGGCGG
ACTAGTAAGTTGCTTCGACCAGACCGGGCA|TGTGGAGAAGTGGCCAATCCTTCGACGGAA
ACAGTGCAGTGCCCCTCATGATAGGCGGAA|ATATGTGCCCGTTTTCCACAATCCGTCTAA
CCCTCATGATAGGCGGAAACTAGTGAGTAA|GTCTTTTTGCCCAATCAGTCAGCTGTTAGG
AGCCCAAATATCAGTGCCCCTCATGATAGG|CGCTCAGAGGCTCAAAGTTCTGACCCAGTT
ATAGGCGGAAACTAGTGCGTCAGTGCCCCT|ATGATAGGCGGAAACTAGTCCCCTCATGAT
ATAGGCGGCAGTGCCCCTCATGATAGGCGG|TGCTTACCGAAAAATTCCAAGCTGTCCTGT
AACTAGTGCGTCAGTGCCCCTCATGATAGG|GGAAACTAGTCCCCTCATGATAGGCGGAAA
ATGATAGGCGGAAACTAGTTCAGTTCGAAT|AGGACGCGGGTCTCTTCCATTCGAGCACAG
AGTAAACTAGTGATAGCCGGATGGTAGAGA|AGAAGAGCGACAGTGCCCCTCATGATAGGC
CAGTGCCCCTCATGATAGGCGGAAACTAGT|TCAAAGTTCTGACCCAGTTGGAACGTTGGT
AACCATTTCACTTGTCTAAGATTAGCCTAA|TTTCTATTCGTGGCGAGAGACTGTATGGGC
CGACCTGTGGAGAAGTGGCCAATCCTTCGA|GGAAACTAGTGCGTCAGTGCCCCTCATGAT
TCAGTGCCCCTCATGATAGGCGGAAACTAG|CCCAGCTGTCTTTTTGCCCAATCAGTCAGC
TACCGAAAAATTCCAAGCTGTCCTGTCTTA|AGCTAGGTGGTATCTTGAGAAACGGACTGG
CTCATGATAGGCGGAAACTAGTTGCGAAGG|ATAGGCGGAAACTAGTGAGCCCAAATATCA
CGTTTTCCACAATCCGTCTAAACCGATCTA|TCAGTGCCCCTCATGATAGGCGGAAACTAG
TCAGTGCCCCTCATGATAGGCGGAAACTAG|CTCAAAGTTCTGACCCAGTTGGAACGTTGG
TCATGATAGGCGGAAACTAGTAAGTTGCTT|ACTTCCCACCCGACCTGTGGAGAAGTGGCC
TAAACGCTCTTCTGTAACCAGATCCCACCA|AGACCGGGCACCCGGAACTATTCCTTAGGT
CGTGGAACCGTCAAAAGAACTCAATTACTT|GAAACTAGTTCAGTTCGAATTCAGTGCCCC
GAAACTAGTGAGCCCAAATATCAGTGCCCC|CGCAAGTCGACGCTCAGAGGCTCAAAGTTC
CAAGGACGCGGGTCTCTTCCATTCGAGCAC|ATCCACCCCTGCGAAAACGCCCCGTTGCGA
GGTACCGCACAGCCCACGCTACCGCAGTGC|CCCTCATGATACAGTGCCCCTCATGATAGG
CCCTCATGATAGGCGGAAACTAGTGAGCCC|TACTACTAGCATCTCCGCAAGTCGACGCTC
TCGTGGCGAGAGACTGTATGGGCAGTGCCC|GATAGGCGGAAACTAGTTAGGCAGAACTGG
AGTGCCCCTCATGATAGGCGGAAACTAGTT|CCTCATGATAGGCGGAAACTAGTGAGCCCA
CAATTACTTTCGCGACACTGGAATCTATGC|CAGTGCCCCTCATGATAGGCGGAAACTAGT
ATCCCACCAACCCGTGGGGCCACCCTAACT|TCCTTAGGTACCGCACAGCCCACGCTACCG
AGTTAGGCAGAACTGGAACTTCCCACCCGA|AGTTGTACAGTGCCCCTCATGATAGGCGGA
TGATAGGCGGAAACTAGTGAGCCCAAATAT|TAGCATCTCCGCAAGTCGACGCTCAGAGGC
TCTAAGATTAGCCTAAAATCCACCCCTGCG|GAGAGACTGTATGGGCAGTGCCCCTCATGA
AGCTTAGATCACTGAAACCATTTCACTTGT|ACCCTAACTATACGGTTTCTATTCGTGGCG
GTAAACTAGTGATAGCCGGATGGTAGAGAT|GAAGAGCGACAGTGCCCCTCATGATAGGCG
ATCATGAAAATAGATATGTGCCCGTTTTCC|GATCGACCAGGATTACGTCGAGTCAGTGCC
TCCAAGCTGTCCTGTCTTAGAGAAGAGCGA|ATCTTGAGAAACGGACTGGGGGTAGGTTGA
GCCCCTCATGATAGGCGGAAACTAGTAAAC|AATTCCAAGCTGTCCTGTCTTAGAGAAGAG
GCGGAAACTAGTAAAAAGGCGAGGGAAGGC|CTCAATTACTTTCGCGACACTGGAATCTAT
GGCGGAAACTAGTTCAGTTCGAATTCAGTG|CGGGTCTCTTCCATTCGAGCACAGCCCAGC
GGTATCTTGAGAAACGGACTGGGGGTAGGT|TAGATCACTGAAACCATTTCACTTGTCTAA
CCGGGCACCCGGAACTATTCCTTAGGTACC|GACGGAACATTCTGACTCCAGTGCCCCTCA
TTCGCGACACTGGAATCTATGCCTAGACGG|CTCATGATAGGCGGAAACTAGTGAGTAATT
TTTCGCGACACTGGAATCTATGCCTAGACG|CCTCATGATAGGCGGAAACTAGTGAGTAAT
GGTCCTTCCTCCGCCGAAGCTTAGATCACT|CACCAACCCGTGGGGCCACCCTAACTATAC
GCGGAAACTAGTGAGTAATTCCTCGAGGCA|AATCAGTCAGCTGTTAGGTCCTTCCTCCGC
CTTAGATCACTGAAACCATTTCACTTGTCT|CCTAACTATACGGTTTCTATTCGTGGCGAG
CTCATGATAGGCGGAAACTAGTAAACTAGT|CCAAGCTGTCCTGTCTTAGAGAAGAGCGAC
ATGATAGGCGGAAACTAGTGGCGGAAACTA|GAGACCGGTGGATATGGTTGCTCTAAAGGC
ACCAGACCGGGCACCCGGAACTATTCCTTA|TCCTTCGACGGAACATTCTGACTCCAGTGC
AGATCGTGGAACCGTCAAAAGAACTCAATT|GGCGGAAACTAGTTCAGTTCGAATTCAGTG
TGGTCCCGACACGATCGACCAGGATTACGT|GGAAGTCGGACGATCTCGTTCGCATATCGT
TAGTGCGTCAGTGCCCCTCATGATAGGCGG|AACTAGTCCCCTCATGATAGGCGGAAACTA
CCCTCATGATAGGCGGAAACTAGTGCGTCA|TGCCCCTCATGATAGGCGGAAACTAGTCCC
TCTCTTCCATTCGAGCACAGCCCAGCTGTC|GAAAACGCCCCGTTGCGATACAATCGCGTG
AGTTGGAACGTTGGTTTTGGTCCCGACACG|AGATCTGTAACAGCACAGGAAGTCGGACGA
GCGTGTAAACGCTCTTCTGTAACCAGATCC|CGACCAGACCGGGCACCCGGAACTATTCCT
CTGTCCTGTCTTAGAGAAGAGCGACAGTGC|AGAAACGGACTGGGGGTAGGTTGACAACGC
GTCGACGCTCAGAGGCTCAAAGTTCTGACC|GCCTAGGTCGCATCTTAGGGATGCGAGACG
CATCTCCGCAAGTCGACGCTCAGAGGCTCA|CGTAGTGCAGAGCCTAGGTCGCATCTTAGG
CTAGTTGCGAAGGTTCCTCTAGGCTGAAAG|AGCCCAAATATCAGTGCCCCTCATGATAGG
CCAGACCGGGCACCCGGAACTATTCCTTAG|CCTTCGACGGAACATTCTGACTCCAGTGCC
TGTCTTTTTGCCCAATCAGTCAGCTGTTAG|CGTGTAAACGCTCTTCTGTAACCAGATCCC
GTTCTATCATGAAAATAGATATGTGCCCGT|GACACGATCGACCAGGATTACGTCGAGTCA
CCCTCATGATAGGCGGAAACTAGTGGCGGA|ACGGCGAGACCGGTGGATATGGTTGCTCTA
GAAACTAGTCCCCTCATGATAGGCGGAAAC|TAAACCGATCTACTACTAGCATCTCCGCAA
CGGAACTATTCCTTAGGTACCGCACAGCCC|TTCTGACTCCAGTGCCCCTCATGATACAGT
CTAGTGAGCCCAAATATCAGTGCCCCTCAT|AGTCGACGCTCAGAGGCTCAAAGTTCTGAC
AAATCCACCCCTGCGAAAACGCCCCGTTGC|CAGTGCCCCTCATGATAGGCGGAAACTAGT
ACGGTTTCTATTCGTGGCGAGAGACTGTAT|GTGCCCCTCATGATAGGCGGAAACTAGTTA
CCGTGGGGCCACCCTAACTATACGGTTTCT|CGCACAGCCCACGCTACCGCAGTGCCCCTC
TTGGTTTTGGTCCCGACACGATCGACCAGG|CAGCACAGGAAGTCGGACGATCTCGTTCGC
CCCCTCATGATAGGCGGAAACTAGTAAAAA|ACCGTCAAAAGAACTCAATTACTTTCGCGA
CCGCCGAAGCTTAGATCACTGAAACCATTT|TGGGGCCACCCTAACTATACGGTTTCTATT
CAGTGCCCCTCATGATAGGCGGAAACTAGT|CCCTCATGATAGGCGGAAACTAGTGAGCCC
GTCAGTGCCCCTCATGATAGGCGGAAACTA|TCCCCTCATGATAGGCGGAAACTAGTGAGC
AAACTAGTAAACTAGTGATAGCCGGATGGT|CTTAGAGAAGAGCGACAGTGCCCCTCATGA
CGGAAACTAGTGAGCCCAAATATCAGTGCC|TCCGCAAGTCGACGCTCAGAGGCTCAAAGT
ACTGAAACCATTTCACTTGTCTAAGATTAG|TACGGTTTCTATTCGTGGCGAGAGACTGTA
TAAAAAGGCGAGGGAAGGCTCAGTGCCCCT|TCGCGACACTGGAATCTATGCCTAGACGGG
ACTTGTCTAAGATTAGCCTAAAATCCACCC|GTGGCGAGAGACTGTATGGGCAGTGCCCCT
AGGCGGAAACTAGTAAAAAGGCGAGGGAAG|AACTCAATTACTTTCGCGACACTGGAATCT
GTCAAAAGAACTCAATTACTTTCGCGACAC|TCAGTTCGAATTCAGTGCCCCTCATGATAG
TAGGCGGAAACTAGTAAGTTGCTTCGACCA|CACCCGACCTGTGGAGAAGTGGCCAATCCT
CGATCTACTACTAGCATCTCCGCAAGTCGA|AAACTAGTGGGAGGCGTAGTGCAGAGCCTA
GCAGAACTGGAACTTCCCACCCGACCTGTG|ACAGTGCCCCTCATGATAGGCGGAAACTAG
GTTAGGCAGAACTGGAACTTCCCACCCGAC|GTTGTACAGTGCCCCTCATGATAGGCGGAA
TAGAGATCGTGGAACCGTCAAAAGAACTCA|ATAGGCGGAAACTAGTTCAGTTCGAATTCA
AGCTAGGTGGTATCTTGAGAAACGGACTGG|CCGAAGCTTAGATCACTGAAACCATTTCAC
TAGGCGGAAACTAGTTCAGTTCGAATTCAG|CGCGGGTCTCTTCCATTCGAGCACAGCCCA
GAAACTAGTGGCGGAAACTAGTTGTACAGT|GATATGGTTGCTCTAAAGGCCAGACAGTGC
TGCCCCTCATGATAGGCGGAAACTAGTAAA|GAACCGTCAAAAGAACTCAATTACTTTCGC
GAGGCTCAAAGTTCTGACCCAGTTGGAACG|ATCTTAGGGATGCGAGACGAAGATCTGTAA
TGCTCTAAAGGCCAGACAGTGCAGTGCCCC|CTATCATGAAAATAGATATGTGCCCGTTTT
CTATTCCTTAGGTACCGCACAGCCCACGCT|ACTCCAGTGCCCCTCATGATACAGTGCCCC
AATTCCAAGCTGTCCTGTCTTAGAGAAGAG|GGTATCTTGAGAAACGGACTGGGGGTAGGT
TCATGATAGGCGGCAGTGCCCCTCATGATA|GAAAGTGCTTACCGAAAAATTCCAAGCTGT
AAATATCAGTGCCCCTCATGATAGGCGGAA|AGAGGCTCAAAGTTCTGACCCAGTTGGAAC
GCTCAGTGCCCCTCATGATAGGCGGCAGTG|ATGCCTAGACGGGAAAGTGCTTACCGAAAA
CAGCTAGGTGGTATCTTGAGAAACGGACTG|GCCGAAGCTTAGATCACTGAAACCATTTCA
ACTAGTGGCGGAAACTAGTTGTACAGTGCC|ATGGTTGCTCTAAAGGCCAGACAGTGCAGT
ACGCGGGTCTCTTCCATTCGAGCACAGCCC|CCCCTGCGAAAACGCCCCGTTGCGATACAA
GTCCTTCCTCCGCCGAAGCTTAGATCACTG|ACCAACCCGTGGGGCCACCCTAACTATACG
GGAAACTAGTGCGTCAGTGCCCCTCATGAT|GGCGGAAACTAGTCCCCTCATGATAGGCGG
GTGAGTAATTCCTCGAGGCAGCTAGGTGGT|CTGTTAGGTCCTTCCTCCGCCGAAGCTTAG
GTAATTCCTCGAGGCAGCTAGGTGGTATCT|TAGGTCCTTCCTCCGCCGAAGCTTAGATCA
TGCCCCTCATGATAGGCGGCAGTGCCCCTC|AGACGGGAAAGTGCTTACCGAAAAATTCCA
GGAAACTAGTGAGTAATTCCTCGAGGCAGC|TCAGTCAGCTGTTAGGTCCTTCCTCCGCCG
CCCTGCGAAAACGCCCCGTTGCGATACAAT|CTCATGATAGGCGGAAACTAGTAAGTTGCT
TAGTTGTACAGTGCCCCTCATGATAGGCGG|GCCAGACAGTGCAGTGCCCCTCATGATAGG
AGGACGCGGGTCTCTTCCATTCGAGCACAG|CCACCCCTGCGAAAACGCCCCGTTGCGATA
GATAGCCGGATGGTAGAGATCGTGGAACCG|AGTGCCCCTCATGATAGGCGGAAACTAGTT
AAGATTAGCCTAAAATCCACCCCTGCGAAA|AGACTGTATGGGCAGTGCCCCTCATGATAG
CCTCATGATAGGCGGAAACTAGTGGCGGAA|CGGCGAGACCGGTGGATATGGTTGCTCTAA
ATAGGCGGAAACTAGTTAGGCAGAACTGGA|AGTGGCGGAAACTAGTTGTACAGTGCCCCT
GCCCAATCAGTCAGCTGTTAGGTCCTTCCT|GCTCTTCTGTAACCAGATCCCACCAACCCG
GGCGGAAACTAGTAAAAAGGCGAGGGAAGG|ACTCAATTACTTTCGCGACACTGGAATCTA
GATCGTGGAACCGTCAAAAGAACTCAATTA|GCGGAAACTAGTTCAGTTCGAATTCAGTGC
GCTTCGACCAGACCGGGCACCCGGAACTAT|GGCCAATCCTTCGACGGAACATTCTGACTC
TCCCCTCATGATAGGCGGAAACTAGTGAGC|TCTACTACTAGCATCTCCGCAAGTCGACGC
TATGTGCCCGTTTTCCACAATCCGTCTAAA|ACGTCGAGTCAGTGCCCCTCATGATAGGCG
GATAGGCGGAAACTAGTAAGTTGCTTCGAC|CCCACCCGACCTGTGGAGAAGTGGCCAATC
CGGGAAAGTGCTTACCGAAAAATTCCAAGC|ATTCCTCGAGGCAGCTAGGTGGTATCTTGA
ACCAGGATTACGTCGAGTCAGTGCCCCTCA|GTTCGCATATCGTTTCGCAGAGGGTGCGGG
CCTCATGATAGGCGGAAACTAGTTAGGCAG|GGAAACTAGTGGCGGAAACTAGTTGTACAG
GGCCACCCTAACTATACGGTTTCTATTCGT|GCCCACGCTACCGCAGTGCCCCTCATGATA
AGCTGTTAGGTCCTTCCTCCGCCGAAGCTT|CCAGATCCCACCAACCCGTGGGGCCACCCT
CGGAAACTAGTGGCGGAAACTAGTTGTACA|TGGATATGGTTGCTCTAAAGGCCAGACAGT
AGAGATCGTGGAACCGTCAAAAGAACTCAA|TAGGCGGAAACTAGTTCAGTTCGAATTCAG
CAAGTCGACGCTCAGAGGCTCAAAGTTCTG|AGAGCCTAGGTCGCATCTTAGGGATGCGAG
CAGTTCGAATTCAGTGCCCCTCATGATAGG|TCGAGCACAGCCCAGCTGTCTTTTTGCCCA
ATTCGAGCACAGCCCAGCTGTCTTTTTGCC|CCCGTTGCGATACAATCGCGTGTAAACGCT
TCCCGACACGATCGACCAGGATTACGTCGA|AGTCGGACGATCTCGTTCGCATATCGTTTC
CCACCAACCCGTGGGGCCACCCTAACTATA|TTAGGTACCGCACAGCCCACGCTACCGCAG
TAGGCAGAACTGGAACTTCCCACCCGACCT|TGTACAGTGCCCCTCATGATAGGCGGAAAC
ATTCAGTGCCCCTCATGATAGGCGGAAACT|AGCCCAGCTGTCTTTTTGCCCAATCAGTCA
TAACCAGATCCCACCAACCCGTGGGGCCAC|GAACTATTCCTTAGGTACCGCACAGCCCAC
TACGTCGAGTCAGTGCCCCTCATGATAGGC|ATCGTTTCGCAGAGGGTGCGGGAGCTCCCG
TTCCTTAGGTACCGCACAGCCCACGCTACC|CCAGTGCCCCTCATGATACAGTGCCCCTCA
GACTGGGGGTAGGTTGACAACGCCGACAAG|TTTCACTTGTCTAAGATTAGCCTAAAATCC
ATCACTGAAACCATTTCACTTGTCTAAGAT|CTATACGGTTTCTATTCGTGGCGAGAGACT
ATTCGTGGCGAGAGACTGTATGGGCAGTGC|ATGATAGGCGGAAACTAGTTAGGCAGAACT
AGAGCGACAGTGCCCCTCATGATAGGCGGA|AGGTTGACAACGCCGACAAGGACGCGGGTC
CCCTCATGATACAGTGCCCCTCATGATAGG|TTCCTCTAGGCTGAAAGACGGCGAGACCGG
GACAGTGCAGTGCCCCTCATGATAGGCGGA|GATATGTGCCCGTTTTCCACAATCCGTCTA
AGACCGGTGGATATGGTTGCTCTAAAGGCC|CTAGTGTATCTTTTGTTCTATCATGAAAAT
ATAGGCGGAAACTAGTGGCGGAAACTAGTT|ACCGGTGGATATGGTTGCTCTAAAGGCCAG
CCCTAACTATACGGTTTCTATTCGTGGCGA|CGCTACCGCAGTGCCCCTCATGATAGGCGG
TGGATATGGTTGCTCTAAAGGCCAGACAGT|ATCTTTTGTTCTATCATGAAAATAGATATG
CCAGACAGTGCAGTGCCCCTCATGATAGGC|ATAGATATGTGCCCGTTTTCCACAATCCGT
GGACGCGGGTCTCTTCCATTCGAGCACAGC|CACCCCTGCGAAAACGCCCCGTTGCGATAC
TCGACCAGACCGGGCACCCGGAACTATTCC|CAATCCTTCGACGGAACATTCTGACTCCAG
CGACACTGGAATCTATGCCTAGACGGGAAA|TGATAGGCGGAAACTAGTGAGTAATTCCTC
TAGGTCCTTCCTCCGCCGAAGCTTAGATCA|CCCACCAACCCGTGGGGCCACCCTAACTAT
ATAGGCGGAAACTAGTAAAAAGGCGAGGGA|AGAACTCAATTACTTTCGCGACACTGGAAT
ATGATAGGCGGCAGTGCCCCTCATGATAGG|AAGTGCTTACCGAAAAATTCCAAGCTGTCC
GGGGGTAGGTTGACAACGCCGACAAGGACG|ACTTGTCTAAGATTAGCCTAAAATCCACCC
TCCTCTAGGCTGAAAGACGGCGAGACCGGT|TGCCCCTCATGATAGGCGGAAACTAGTGTA
ATGATAGGCGGAAACTAGTCCCCTCATGAT|ACAATCCGTCTAAACCGATCTACTACTAGC
CCAGCTGTCTTTTTGCCCAATCAGTCAGCT|AATCGCGTGTAAACGCTCTTCTGTAACCAG
TCAAAAGAACTCAATTACTTTCGCGACACT|CAGTTCGAATTCAGTGCCCCTCATGATAGG
TTTTTGCCCAATCAGTCAGCTGTTAGGTCC|TAAACGCTCTTCTGTAACCAGATCCCACCA
GACCTGTGGAGAAGTGGCCAATCCTTCGAC|GAAACTAGTGCGTCAGTGCCCCTCATGATA
CGTGGGGCCACCCTAACTATACGGTTTCTA|GCACAGCCCACGCTACCGCAGTGCCCCTCA
TAACTATACGGTTTCTATTCGTGGCGAGAG|TACCGCAGTGCCCCTCATGATAGGCGGAAA
CAGTCAGCTGTTAGGTCCTTCCTCCGCCGA|TGTAACCAGATCCCACCAACCCGTGGGGCC
ATGATAGGCGGAAACTAGTGAGTAATTCCT|TTTGCCCAATCAGTCAGCTGTTAGGTCCTT
GACCCAGTTGGAACGTTGGTTTTGGTCCCG|GACGAAGATCTGTAACAGCACAGGAAGTCG
ACAGTGCCCCTCATGATAGGCGGAAACTAG|ACAACGCCGACAAGGACGCGGGTCTCTTCC
GGGAAGGCTCAGTGCCCCTCATGATAGGCG|GAATCTATGCCTAGACGGGAAAGTGCTTAC
CCAACCCGTGGGGCCACCCTAACTATACGG|GGTACCGCACAGCCCACGCTACCGCAGTGC
ATCGCGTGTAAACGCTCTTCTGTAACCAGA|CTTCGACCAGACCGGGCACCCGGAACTATT
CTCAGTGCCCCTCATGATAGGCGGCAGTGC|TGCCTAGACGGGAAAGTGCTTACCGAAAAA
CCTCATGATAGGCGGAAACTAGTGCGTCAG|GCCCCTCATGATAGGCGGAAACTAGTCCCC
CGTCAAAAGAACTCAATTACTTTCGCGACA|TTCAGTTCGAATTCAGTGCCCCTCATGATA
ATGATAGGCGGAAACTAGTTAGGCAGAACT|ACTAGTGGCGGAAACTAGTTGTACAGTGCC
GAACCGTCAAAAGAACTCAATTACTTTCGC|CTAGTTCAGTTCGAATTCAGTGCCCCTCAT
GGATGGTAGAGATCGTGGAACCGTCAAAAG|CTCATGATAGGCGGAAACTAGTTCAGTTCG
ACTAGTAAACTAGTGATAGCCGGATGGTAG|TAGAGAAGAGCGACAGTGCCCCTCATGATA
GGAAACTAGTGAGCCCAAATATCAGTGCCC|CCGCAAGTCGACGCTCAGAGGCTCAAAGTT
TTAGAGAAGAGCGACAGTGCCCCTCATGAT|TGGGGGTAGGTTGACAACGCCGACAAGGAC
GATAGGCGGAAACTAGTGCGTCAGTGCCCC|CATGATAGGCGGAAACTAGTCCCCTCATGA
GCCCCTCATGATAGGCGGAAACTAGTAAGT|CTGGAACTTCCCACCCGACCTGTGGAGAAG
TAGATCACTGAAACCATTTCACTTGTCTAA|TAACTATACGGTTTCTATTCGTGGCGAGAG
AAACTAGTAAGTTGCTTCGACCAGACCGGG|CCTGTGGAGAAGTGGCCAATCCTTCGACGG
TCATGATAGGCGGAAACTAGTGTATCTTTT|TGACCCAGTTGGAACGTTGGTTTTGGTCCC
ACCCGTGGGGCCACCCTAACTATACGGTTT|ACCGCACAGCCCACGCTACCGCAGTGCCCC
TAGGCGGAAACTAGTGCGTCAGTGCCCCTC|TGATAGGCGGAAACTAGTCCCCTCATGATA
TGTAAACGCTCTTCTGTAACCAGATCCCAC|CCAGACCGGGCACCCGGAACTATTCCTTAG
TCAGTGCCCCTCATGATAGGCGGAAACTAG|CGTGGAACCGTCAAAAGAACTCAATTACTT
CCGCAAGTCGACGCTCAGAGGCTCAAAGTT|TGCAGAGCCTAGGTCGCATCTTAGGGATGC
CTAAAGGCCAGACAGTGCAGTGCCCCTCAT|CATGAAAATAGATATGTGCCCGTTTTCCAC
ATAGGCGGAAACTAGTTCAGTTCGAATTCA|ACGCGGGTCTCTTCCATTCGAGCACAGCCC
GAAACTAGTAAACTAGTGATAGCCGGATGG|TCTTAGAGAAGAGCGACAGTGCCCCTCATG
TTGTCTAAGATTAGCCTAAAATCCACCCCT|GGCGAGAGACTGTATGGGCAGTGCCCCTCA
CACCAACCCGTGGGGCCACCCTAACTATAC|TAGGTACCGCACAGCCCACGCTACCGCAGT
AGTAAAAAGGCGAGGGAAGGCTCAGTGCCC|TTTCGCGACACTGGAATCTATGCCTAGACG
CTCTAGGCTGAAAGACGGCGAGACCGGTGG|CCCCTCATGATAGGCGGAAACTAGTGTATC
CTTCCCACCCGACCTGTGGAGAAGTGGCCA|ATGATAGGCGGAAACTAGTGCGTCAGTGCC
ATGGTTGCTCTAAAGGCCAGACAGTGCAGT|TTGTTCTATCATGAAAATAGATATGTGCCC
CTGGAATCTATGCCTAGACGGGAAAGTGCT|GGCGGAAACTAGTGAGTAATTCCTCGAGGC
AGCCCAGCTGTCTTTTTGCCCAATCAGTCA|TACAATCGCGTGTAAACGCTCTTCTGTAAC
TTGCGAAGGTTCCTCTAGGCTGAAAGACGG|CAAATATCAGTGCCCCTCATGATAGGCGGA
GACGGGAAAGTGCTTACCGAAAAATTCCAA|TAATTCCTCGAGGCAGCTAGGTGGTATCTT
CCTCCGCCGAAGCTTAGATCACTGAAACCA|CCGTGGGGCCACCCTAACTATACGGTTTCT
AATCGCGTGTAAACGCTCTTCTGTAACCAG|GCTTCGACCAGACCGGGCACCCGGAACTAT
AGATCACTGAAACCATTTCACTTGTCTAAG|AACTATACGGTTTCTATTCGTGGCGAGAGA
CGGACTGGGGGTAGGTTGACAACGCCGACA|CATTTCACTTGTCTAAGATTAGCCTAAAAT
GCGAGGGAAGGCTCAGTGCCCCTCATGATA|ACTGGAATCTATGCCTAGACGGGAAAGTGC
AGTTGCTTCGACCAGACCGGGCACCCGGAA|AAGTGGCCAATCCTTCGACGGAACATTCTG
GCTAGGTGGTATCTTGAGAAACGGACTGGG|CGAAGCTTAGATCACTGAAACCATTTCACT
AATCAGTCAGCTGTTAGGTCCTTCCTCCGC|TTCTGTAACCAGATCCCACCAACCCGTGGG
AGTGCCCCTCATGATAGGCGGAAACTAGTT|AACGCCGACAAGGACGCGGGTCTCTTCCAT
GAAAAATTCCAAGCTGTCCTGTCTTAGAGA|AGGTGGTATCTTGAGAAACGGACTGGGGGT
AGTGATAGCCGGATGGTAGAGATCGTGGAA|GACAGTGCCCCTCATGATAGGCGGAAACTA
TCATGATAGGCGGAAACTAGTTAGGCAGAA|AAACTAGTGGCGGAAACTAGTTGTACAGTG
GCGACAGTGCCCCTCATGATAGGCGGAAAC|TTGACAACGCCGACAAGGACGCGGGTCTCT
GGGCCACCCTAACTATACGGTTTCTATTCG|AGCCCACGCTACCGCAGTGCCCCTCATGAT
TTAGGTACCGCACAGCCCACGCTACCGCAG|TGCCCCTCATGATACAGTGCCCCTCATGAT
TGAGTAATTCCTCGAGGCAGCTAGGTGGTA|TGTTAGGTCCTTCCTCCGCCGAAGCTTAGA
ATGTGCCCGTTTTCCACAATCCGTCTAAAC|CGTCGAGTCAGTGCCCCTCATGATAGGCGG
CACCCGGAACTATTCCTTAGGTACCGCACA|AACATTCTGACTCCAGTGCCCCTCATGATA
CGGATGGTAGAGATCGTGGAACCGTCAAAA|CCTCATGATAGGCGGAAACTAGTTCAGTTC
CGCTACCGCAGTGCCCCTCATGATAGGCGG|CCCCTCATGATAGGCGGAAACTAGTGGCGG
TATCATGAAAATAGATATGTGCCCGTTTTC|CGATCGACCAGGATTACGTCGAGTCAGTGC
GCTGAAAGACGGCGAGACCGGTGGATATGG|ATGATAGGCGGAAACTAGTGTATCTTTTGT
CTGTCTTTTTGCCCAATCAGTCAGCTGTTA|GCGTGTAAACGCTCTTCTGTAACCAGATCC
AAGCTGTCCTGTCTTAGAGAAGAGCGACAG|TTGAGAAACGGACTGGGGGTAGGTTGACAA
AGTGCCCCTCATGATAGGCGGAAACTAGTA|AAAAATTCCAAGCTGTCCTGTCTTAGAGAA
GCCCCGTTGCGATACAATCGCGTGTAAACG|GGAAACTAGTAAGTTGCTTCGACCAGACCG
ACTAGTTCAGTTCGAATTCAGTGCCCCTCA|CTTCCATTCGAGCACAGCCCAGCTGTCTTT
TGACAACGCCGACAAGGACGCGGGTCTCTT|GATTAGCCTAAAATCCACCCCTGCGAAAAC
TCATGATAGGCGGAAACTAGTGAGTAATTC|TTTTTGCCCAATCAGTCAGCTGTTAGGTCC
ATTACTTTCGCGACACTGGAATCTATGCCT|GTGCCCCTCATGATAGGCGGAAACTAGTGA
GTTGACAACGCCGACAAGGACGCGGGTCTC|AAGATTAGCCTAAAATCCACCCCTGCGAAA
GGCGGAAACTAGTGTATCTTTTGTTCTATC|TTGGAACGTTGGTTTTGGTCCCGACACGAT
GTGGCCAATCCTTCGACGGAACATTCTGAC|CAGTGCCCCTCATGATAGGCGGAAACTAGT
TGGAATCTATGCCTAGACGGGAAAGTGCTT|GCGGAAACTAGTGAGTAATTCCTCGAGGCA
CTATCATGAAAATAGATATGTGCCCGTTTT|ACGATCGACCAGGATTACGTCGAGTCAGTG
GAACTTCCCACCCGACCTGTGGAGAAGTGG|CTCATGATAGGCGGAAACTAGTGCGTCAGT
TGGAGAAGTGGCCAATCCTTCGACGGAACA|AGTGCGTCAGTGCCCCTCATGATAGGCGGA
TGGTTGCTCTAAAGGCCAGACAGTGCAGTG|TGTTCTATCATGAAAATAGATATGTGCCCG
GTGCCCCTCATGATAGGCGGAAACTAGTGT|AAAGTTCTGACCCAGTTGGAACGTTGGTTT
AAACTAGTTCAGTTCGAATTCAGTGCCCCT|CTCTTCCATTCGAGCACAGCCCAGCTGTCT
TATTCGTGGCGAGAGACTGTATGGGCAGTG|CATGATAGGCGGAAACTAGTTAGGCAGAAC
GATAGGCGGAAACTAGTAAAAAGGCGAGGG|AAGAACTCAATTACTTTCGCGACACTGGAA
GAATCTATGCCTAGACGGGAAAGTGCTTAC|GGAAACTAGTGAGTAATTCCTCGAGGCAGC
GAATTCAGTGCCCCTCATGATAGGCGGAAA|ACAGCCCAGCTGTCTTTTTGCCCAATCAGT
CTGTATGGGCAGTGCCCCTCATGATAGGCG|TAGTTAGGCAGAACTGGAACTTCCCACCCG
TTCGAATTCAGTGCCCCTCATGATAGGCGG|AGCACAGCCCAGCTGTCTTTTTGCCCAATC
ACCCGACCTGTGGAGAAGTGGCCAATCCTT|GGCGGAAACTAGTGCGTCAGTGCCCCTCAT
ACGCTCTTCTGTAACCAGATCCCACCAACC|CCGGGCACCCGGAACTATTCCTTAGGTACC
AAACTAGTGAGCCCAAATATCAGTGCCCCT|GCAAGTCGACGCTCAGAGGCTCAAAGTTCT
AGTGCCCCTCATGATAGGCGGAAACTAGTC|CCCGTTTTCCACAATCCGTCTAAACCGATC
GAGCACAGCCCAGCTGTCTTTTTGCCCAAT|TTGCGATACAATCGCGTGTAAACGCTCTTC
TTTTGTTCTATCATGAAAATAGATATGTGC|TCCCGACACGATCGACCAGGATTACGTCGA
TCCGCCGAAGCTTAGATCACTGAAACCATT|GTGGGGCCACCCTAACTATACGGTTTCTAT
ACCGTCAAAAGAACTCAATTACTTTCGCGA|AGTTCAGTTCGAATTCAGTGCCCCTCATGA
TTAGCCTAAAATCCACCCCTGCGAAAACGC|TGTATGGGCAGTGCCCCTCATGATAGGCGG
TTACCGAAAAATTCCAAGCTGTCCTGTCTT|CAGCTAGGTGGTATCTTGAGAAACGGACTG
GCGGAAACTAGTGTATCTTTTGTTCTATCA|TGGAACGTTGGTTTTGGTCCCGACACGATC
TCCAGTGCCCCTCATGATACAGTGCCCCTC|TGCGAAGGTTCCTCTAGGCTGAAAGACGGC
GAGTAATTCCTCGAGGCAGCTAGGTGGTAT|GTTAGGTCCTTCCTCCGCCGAAGCTTAGAT
TCGAGCACAGCCCAGCTGTCTTTTTGCCCA|CGTTGCGATACAATCGCGTGTAAACGCTCT
GCCCCTCATGATAGGCGGAAACTAGTTAGG|GGCGGAAACTAGTGGCGGAAACTAGTTGTA
ATAGGCGGAAACTAGTTGCGAAGGTTCCTC|GGAAACTAGTGAGCCCAAATATCAGTGCCC
CGAGCACAGCCCAGCTGTCTTTTTGCCCAA|GTTGCGATACAATCGCGTGTAAACGCTCTT
AATAGATATGTGCCCGTTTTCCACAATCCG|AGGATTACGTCGAGTCAGTGCCCCTCATGA
GGCGGAAACTAGTTGCGAAGGTTCCTCTAG|AACTAGTGAGCCCAAATATCAGTGCCCCTC
AACTTCCCACCCGACCTGTGGAGAAGTGGC|TCATGATAGGCGGAAACTAGTGCGTCAGTG
ACTATTCCTTAGGTACCGCACAGCCCACGC|GACTCCAGTGCCCCTCATGATACAGTGCCC
CCAGATCCCACCAACCCGTGGGGCCACCCT|CTATTCCTTAGGTACCGCACAGCCCACGCT
GATGGTAGAGATCGTGGAACCGTCAAAAGA|TCATGATAGGCGGAAACTAGTTCAGTTCGA
GTGCCCCTCATGATAGGCGGAAACTAGTAA|AAAATTCCAAGCTGTCCTGTCTTAGAGAAG
TCATGATAGGCGGAAACTAGTGGCGGAAAC|GCGAGACCGGTGGATATGGTTGCTCTAAAG
TTCGTGGCGAGAGACTGTATGGGCAGTGCC|TGATAGGCGGAAACTAGTTAGGCAGAACTG
GGCGGAAACTAGTAAGTTGCTTCGACCAGA|CCCGACCTGTGGAGAAGTGGCCAATCCTTC
TTTCACTTGTCTAAGATTAGCCTAAAATCC|ATTCGTGGCGAGAGACTGTATGGGCAGTGC
GTGGGGCCACCCTAACTATACGGTTTCTAT|CACAGCCCACGCTACCGCAGTGCCCCTCAT
GTTGGAACGTTGGTTTTGGTCCCGACACGA|GATCTGTAACAGCACAGGAAGTCGGACGAT
CCGCACAGCCCACGCTACCGCAGTGCCCCT|CATGATACAGTGCCCCTCATGATAGGCGGA
GAAACTAGTTGTACAGTGCCCCTCATGATA|TAAAGGCCAGACAGTGCAGTGCCCCTCATG
CCCTCATGATAGGCGGAAACTAGTAAACTA|TTCCAAGCTGTCCTGTCTTAGAGAAGAGCG
TTCCAAGCTGTCCTGTCTTAGAGAAGAGCG|TATCTTGAGAAACGGACTGGGGGTAGGTTG
TTGCGATACAATCGCGTGTAAACGCTCTTC|TAGTAAGTTGCTTCGACCAGACCGGGCACC
GGTCCCGACACGATCGACCAGGATTACGTC|GAAGTCGGACGATCTCGTTCGCATATCGTT
TACCGCACAGCCCACGCTACCGCAGTGCCC|CTCATGATACAGTGCCCCTCATGATAGGCG
GGCTCAGTGCCCCTCATGATAGGCGGCAGT|TATGCCTAGACGGGAAAGTGCTTACCGAAA
AAACTAGTGGCGGAAACTAGTTGTACAGTG|ATATGGTTGCTCTAAAGGCCAGACAGTGCA
AAACGGACTGGGGGTAGGTTGACAACGCCG|AACCATTTCACTTGTCTAAGATTAGCCTAA
CGAGTCAGTGCCCCTCATGATAGGCGGAAA|TTCGCAGAGGGTGCGGGAGCTCCCGGGGAC
CGTTGGTTTTGGTCCCGACACGATCGACCA|AACAGCACAGGAAGTCGGACGATCTCGTTC
CAGTGCCCCTCATGATAGGCGGAAACTAGT|GAAAAATTCCAAGCTGTCCTGTCTTAGAGA
GGTAGGTTGACAACGCCGACAAGGACGCGG|TGTCTAAGATTAGCCTAAAATCCACCCCTG
TTTGCCCAATCAGTCAGCTGTTAGGTCCTT|AACGCTCTTCTGTAACCAGATCCCACCAAC
TGGCGAGAGACTGTATGGGCAGTGCCCCTC|AGGCGGAAACTAGTTAGGCAGAACTGGAAC
ACAGTGCCCCTCATGATAGGCGGAAACTAG|AGTGCAGTGCCCCTCATGATAGGCGGAAAC
TGTCCTGTCTTAGAGAAGAGCGACAGTGCC|GAAACGGACTGGGGGTAGGTTGACAACGCC
GGCGAGGGAAGGCTCAGTGCCCCTCATGAT|CACTGGAATCTATGCCTAGACGGGAAAGTG
CCGTTTTCCACAATCCGTCTAAACCGATCT|GTCAGTGCCCCTCATGATAGGCGGAAACTA
AACTATTCCTTAGGTACCGCACAGCCCACG|TGACTCCAGTGCCCCTCATGATACAGTGCC
TTCCTCGAGGCAGCTAGGTGGTATCTTGAG|TCCTTCCTCCGCCGAAGCTTAGATCACTGA
AACTAGTTAGGCAGAACTGGAACTTCCCAC|AACTAGTTGTACAGTGCCCCTCATGATAGG
GCGGAAACTAGTTAGGCAGAACTGGAACTT|GCGGAAACTAGTTGTACAGTGCCCCTCATG
AGTGCCCCTCATGATAGGCGGAAACTAGTT|ATAGGCGGAAACTAGTGGCGGAAACTAGTT
AGTCAGCTGTTAGGTCCTTCCTCCGCCGAA|GTAACCAGATCCCACCAACCCGTGGGGCCA
GTTTTGGTCCCGACACGATCGACCAGGATT|CACAGGAAGTCGGACGATCTCGTTCGCATA
TGGAACCGTCAAAAGAACTCAATTACTTTC|AACTAGTTCAGTTCGAATTCAGTGCCCCTC
CTACTACTAGCATCTCCGCAAGTCGACGCT|TAGTGGGAGGCGTAGTGCAGAGCCTAGGTC
AGTGCCCCTCATGATACAGTGCCCCTCATG|GAAGGTTCCTCTAGGCTGAAAGACGGCGAG
CAAAGTTCTGACCCAGTTGGAACGTTGGTT|GGGATGCGAGACGAAGATCTGTAACAGCAC
CGATACAATCGCGTGTAAACGCTCTTCTGT|TAAGTTGCTTCGACCAGACCGGGCACCCGG
CGTCAGTGCCCCTCATGATAGGCGGAAACT|GTCCCCTCATGATAGGCGGAAACTAGTGAG
CTAGTTGTACAGTGCCCCTCATGATAGGCG|GGCCAGACAGTGCAGTGCCCCTCATGATAG
TAGGCGGCAGTGCCCCTCATGATAGGCGGA|GCTTACCGAAAAATTCCAAGCTGTCCTGTC
GTTCGAATTCAGTGCCCCTCATGATAGGCG|GAGCACAGCCCAGCTGTCTTTTTGCCCAAT
CAAAAGAACTCAATTACTTTCGCGACACTG|AGTTCGAATTCAGTGCCCCTCATGATAGGC
GTGCCCCTCATGATAGGCGGAAACTAGTTG|CTCATGATAGGCGGAAACTAGTGAGCCCAA
CCCTCATGATAGGCGGAAACTAGTAAAAAG|CCGTCAAAAGAACTCAATTACTTTCGCGAC
CCAAGCTGTCCTGTCTTAGAGAAGAGCGAC|TCTTGAGAAACGGACTGGGGGTAGGTTGAC
TACTTTCGCGACACTGGAATCTATGCCTAG|GCCCCTCATGATAGGCGGAAACTAGTGAGT
TGAGAAACGGACTGGGGGTAGGTTGACAAC|CTGAAACCATTTCACTTGTCTAAGATTAGC
AACTAGTGAGTAATTCCTCGAGGCAGCTAG|GTCAGCTGTTAGGTCCTTCCTCCGCCGAAG
TCCTTCCTCCGCCGAAGCTTAGATCACTGA|CCAACCCGTGGGGCCACCCTAACTATACGG
GGTTTCTATTCGTGGCGAGAGACTGTATGG|GCCCCTCATGATAGGCGGAAACTAGTTAGG
AGTGCCCCTCATGATAGGCGGAAACTAGTG|GAAAGACGGCGAGACCGGTGGATATGGTTG
TTTGGTCCCGACACGATCGACCAGGATTAC|CAGGAAGTCGGACGATCTCGTTCGCATATC
AAAGACGGCGAGACCGGTGGATATGGTTGC|TAGGCGGAAACTAGTGTATCTTTTGTTCTA
AAATAGATATGTGCCCGTTTTCCACAATCC|CAGGATTACGTCGAGTCAGTGCCCCTCATG
CAGCCCACGCTACCGCAGTGCCCCTCATGA|TACAGTGCCCCTCATGATAGGCGGAAACTA
AAACCATTTCACTTGTCTAAGATTAGCCTA|GTTTCTATTCGTGGCGAGAGACTGTATGGG
CTATGCCTAGACGGGAAAGTGCTTACCGAA|ACTAGTGAGTAATTCCTCGAGGCAGCTAGG
CACGATCGACCAGGATTACGTCGAGTCAGT|ACGATCTCGTTCGCATATCGTTTCGCAGAG
TCTTTTGTTCTATCATGAAAATAGATATGT|GGTCCCGACACGATCGACCAGGATTACGTC
CTCCGCCGAAGCTTAGATCACTGAAACCAT|CGTGGGGCCACCCTAACTATACGGTTTCTA
GCAGTGCCCCTCATGATAGGCGGAAACTAG|CGAAAAATTCCAAGCTGTCCTGTCTTAGAG
CAGACAGTGCAGTGCCCCTCATGATAGGCG|TAGATATGTGCCCGTTTTCCACAATCCGTC
ATAGGCGGAAACTAGTGAGTAATTCCTCGA|GCCCAATCAGTCAGCTGTTAGGTCCTTCCT
CCAATCCTTCGACGGAACATTCTGACTCCA|GCCCCTCATGATAGGCGGAAACTAGTTGCG
TCCTTAGGTACCGCACAGCCCACGCTACCG|CAGTGCCCCTCATGATACAGTGCCCCTCAT
GTGCCCGTTTTCCACAATCCGTCTAAACCG|TCGAGTCAGTGCCCCTCATGATAGGCGGAA
TCTAGGCTGAAAGACGGCGAGACCGGTGGA|CCCTCATGATAGGCGGAAACTAGTGTATCT
GCCGAAGCTTAGATCACTGAAACCATTTCA|GGGCCACCCTAACTATACGGTTTCTATTCG
CAGTGCCCCTCATGATAGGCGGAAACTAGT|AGAACTGGAACTTCCCACCCGACCTGTGGA
AGACCGGGCACCCGGAACTATTCCTTAGGT|TTCGACGGAACATTCTGACTCCAGTGCCCC
GGTTCCTCTAGGCTGAAAGACGGCGAGACC|CAGTGCCCCTCATGATAGGCGGAAACTAGT
TGATAGGCGGAAACTAGTGAGTAATTCCTC|TTGCCCAATCAGTCAGCTGTTAGGTCCTTC
TGATAGGCGGAAACTAGTCCCCTCATGATA|CAATCCGTCTAAACCGATCTACTACTAGCA
CTCAAAGTTCTGACCCAGTTGGAACGTTGG|TAGGGATGCGAGACGAAGATCTGTAACAGC
GCGGAAACTAGTAAGTTGCTTCGACCAGAC|CCGACCTGTGGAGAAGTGGCCAATCCTTCG
GAAGCTTAGATCACTGAAACCATTTCACTT|CCACCCTAACTATACGGTTTCTATTCGTGG
CAGTTGGAACGTTGGTTTTGGTCCCGACAC|AAGATCTGTAACAGCACAGGAAGTCGGACG
CCACCCTAACTATACGGTTTCTATTCGTGG|CCACGCTACCGCAGTGCCCCTCATGATAGG
TGATAGGCGGAAACTAGTTCAGTTCGAATT|GGACGCGGGTCTCTTCCATTCGAGCACAGC
ATGATAGGCGGAAACTAGTGCGTCAGTGCC|CTCATGATAGGCGGAAACTAGTCCCCTCAT
CTAACTATACGGTTTCTATTCGTGGCGAGA|CTACCGCAGTGCCCCTCATGATAGGCGGAA
GCGGAAACTAGTTCAGTTCGAATTCAGTGC|GGGTCTCTTCCATTCGAGCACAGCCCAGCT
CTCATGATAGGCGGAAACTAGTTCAGTTCG|ACAAGGACGCGGGTCTCTTCCATTCGAGCA
GAAACTAGTTGCGAAGGTTCCTCTAGGCTG|AGTGAGCCCAAATATCAGTGCCCCTCATGA
CTTTTTGCCCAATCAGTCAGCTGTTAGGTC|GTAAACGCTCTTCTGTAACCAGATCCCACC
AATCCGTCTAAACCGATCTACTACTAGCAT|TCATGATAGGCGGAAACTAGTGGGAGGCGT
AGTGCCCCTCATGATAGGCGGAAACTAGTA|GAACTGGAACTTCCCACCCGACCTGTGGAG
GGAAACTAGTTGCGAAGGTTCCTCTAGGCT|TAGTGAGCCCAAATATCAGTGCCCCTCATG
TGATAGGCGGAAACTAGTGTATCTTTTGTT|CCCAGTTGGAACGTTGGTTTTGGTCCCGAC
CCTCTAGGCTGAAAGACGGCGAGACCGGTG|GCCCCTCATGATAGGCGGAAACTAGTGTAT
TAGGCGGAAACTAGTAAAAAGGCGAGGGAA|GAACTCAATTACTTTCGCGACACTGGAATC
GCAGTGCCCCTCATGATAGGCGGAAACTAG|TGATAGGCGGAAACTAGTGGCGGAAACTAG
TGATACAGTGCCCCTCATGATAGGCGGAAA|TAGGCTGAAAGACGGCGAGACCGGTGGATA
CCCCTCATGATAGGCGGAAACTAGTTGCGA|ATGATAGGCGGAAACTAGTGAGCCCAAATA
GTTAGGTCCTTCCTCCGCCGAAGCTTAGAT|ATCCCACCAACCCGTGGGGCCACCCTAACT
TGATAGGCGGAAACTAGTTGCGAAGGTTCC|GCGGAAACTAGTGAGCCCAAATATCAGTGC
GTGGATATGGTTGCTCTAAAGGCCAGACAG|TATCTTTTGTTCTATCATGAAAATAGATAT
CGAAGGTTCCTCTAGGCTGAAAGACGGCGA|ATATCAGTGCCCCTCATGATAGGCGGAAAC
ACTAGTGAGCCCAAATATCAGTGCCCCTCA|AAGTCGACGCTCAGAGGCTCAAAGTTCTGA
TGCCCCTCATGATAGGCGGAAACTAGTAAG|ACTGGAACTTCCCACCCGACCTGTGGAGAA
TCTTTTTGCCCAATCAGTCAGCTGTTAGGT|TGTAAACGCTCTTCTGTAACCAGATCCCAC
CAATCCGTCTAAACCGATCTACTACTAGCA|CTCATGATAGGCGGAAACTAGTGGGAGGCG
TGCGATACAATCGCGTGTAAACGCTCTTCT|AGTAAGTTGCTTCGACCAGACCGGGCACCC
AGAAGAGCGACAGTGCCCCTCATGATAGGC|GGTAGGTTGACAACGCCGACAAGGACGCGG
ACGATCGACCAGGATTACGTCGAGTCAGTG|CGATCTCGTTCGCATATCGTTTCGCAGAGG
CACGCTACCGCAGTGCCCCTCATGATAGGC|TGCCCCTCATGATAGGCGGAAACTAGTGGC
ACTGGAATCTATGCCTAGACGGGAAAGTGC|AGGCGGAAACTAGTGAGTAATTCCTCGAGG
AGTTCAGTTCGAATTCAGTGCCCCTCATGA|CCATTCGAGCACAGCCCAGCTGTCTTTTTG
GGCAGTGCCCCTCATGATAGGCGGAAACTA|GCAGAACTGGAACTTCCCACCCGACCTGTG
TTAGGTCCTTCCTCCGCCGAAGCTTAGATC|TCCCACCAACCCGTGGGGCCACCCTAACTA
AACTAGTCCCCTCATGATAGGCGGAAACTA|AACCGATCTACTACTAGCATCTCCGCAAGT
TGCCCGTTTTCCACAATCCGTCTAAACCGA|CGAGTCAGTGCCCCTCATGATAGGCGGAAA
ACCCAGTTGGAACGTTGGTTTTGGTCCCGA|ACGAAGATCTGTAACAGCACAGGAAGTCGG
CCTCGAGGCAGCTAGGTGGTATCTTGAGAA|CTTCCTCCGCCGAAGCTTAGATCACTGAAA
GGGCACCCGGAACTATTCCTTAGGTACCGC|CGGAACATTCTGACTCCAGTGCCCCTCATG
AGTGAGTAATTCCTCGAGGCAGCTAGGTGG|GCTGTTAGGTCCTTCCTCCGCCGAAGCTTA
TGTCTTAGAGAAGAGCGACAGTGCCCCTCA|GGACTGGGGGTAGGTTGACAACGCCGACAA
CATTCGAGCACAGCCCAGCTGTCTTTTTGC|CCCCGTTGCGATACAATCGCGTGTAAACGC
GTGCAGTGCCCCTCATGATAGGCGGAAACT|TGTGCCCGTTTTCCACAATCCGTCTAAACC
GCACAGCCCACGCTACCGCAGTGCCCCTCA|TGATACAGTGCCCCTCATGATAGGCGGAAA
TCGACGGAACATTCTGACTCCAGTGCCCCT|TGATAGGCGGAAACTAGTTGCGAAGGTTCC
TTGTACAGTGCCCCTCATGATAGGCGGAAA|AGACAGTGCAGTGCCCCTCATGATAGGCGG
GCGGAAACTAGTTGCGAAGGTTCCTCTAGG|ACTAGTGAGCCCAAATATCAGTGCCCCTCA
TTCTATTCGTGGCGAGAGACTGTATGGGCA|CCTCATGATAGGCGGAAACTAGTTAGGCAG
CATGATAGGCGGAAACTAGTTGCGAAGGTT|AGGCGGAAACTAGTGAGCCCAAATATCAGT
AGGCGGAAACTAGTAAGTTGCTTCGACCAG|ACCCGACCTGTGGAGAAGTGGCCAATCCTT
GCCCCTCATGATACAGTGCCCCTCATGATA|GGTTCCTCTAGGCTGAAAGACGGCGAGACC
TAGTTGCGAAGGTTCCTCTAGGCTGAAAGA|GCCCAAATATCAGTGCCCCTCATGATAGGC
AGGCTGAAAGACGGCGAGACCGGTGGATAT|TCATGATAGGCGGAAACTAGTGTATCTTTT
GCAGTGCCCCTCATGATAGGCGGAAACTAG|TGCCCGTTTTCCACAATCCGTCTAAACCGA
AGACAGTGCAGTGCCCCTCATGATAGGCGG|AGATATGTGCCCGTTTTCCACAATCCGTCT
ACAATCCGTCTAAACCGATCTACTACTAGC|CCTCATGATAGGCGGAAACTAGTGGGAGGC
TGAAACCATTTCACTTGTCTAAGATTAGCC|CGGTTTCTATTCGTGGCGAGAGACTGTATG
TAAACTAGTGATAGCCGGATGGTAGAGATC|AAGAGCGACAGTGCCCCTCATGATAGGCGG
ACTTTCGCGACACTGGAATCTATGCCTAGA|CCCCTCATGATAGGCGGAAACTAGTGAGTA
TGTTCTATCATGAAAATAGATATGTGCCCG|CGACACGATCGACCAGGATTACGTCGAGTC
CTGTAACCAGATCCCACCAACCCGTGGGGC|CCGGAACTATTCCTTAGGTACCGCACAGCC
AGGCGGAAACTAGTGCGTCAGTGCCCCTCA|GATAGGCGGAAACTAGTCCCCTCATGATAG
CGAAGCTTAGATCACTGAAACCATTTCACT|GCCACCCTAACTATACGGTTTCTATTCGTG
AACTAGTGGCGGAAACTAGTTGTACAGTGC|TATGGTTGCTCTAAAGGCCAGACAGTGCAG
CCCGACACGATCGACCAGGATTACGTCGAG|GTCGGACGATCTCGTTCGCATATCGTTTCG
TACAGTGCCCCTCATGATAGGCGGAAACTA|CAGTGCAGTGCCCCTCATGATAGGCGGAAA
GACACTGGAATCTATGCCTAGACGGGAAAG|GATAGGCGGAAACTAGTGAGTAATTCCTCG
GAAACTAGTGCGTCAGTGCCCCTCATGATA|GCGGAAACTAGTCCCCTCATGATAGGCGGA
CATGAAAATAGATATGTGCCCGTTTTCCAC|TCGACCAGGATTACGTCGAGTCAGTGCCCC
AACGCTCTTCTGTAACCAGATCCCACCAAC|ACCGGGCACCCGGAACTATTCCTTAGGTAC
TGCCTAGACGGGAAAGTGCTTACCGAAAAA|AGTGAGTAATTCCTCGAGGCAGCTAGGTGG
GACCAGACCGGGCACCCGGAACTATTCCTT|ATCCTTCGACGGAACATTCTGACTCCAGTG
TCTATGCCTAGACGGGAAAGTGCTTACCGA|AACTAGTGAGTAATTCCTCGAGGCAGCTAG
CAGTGCCCCTCATGATAGGCGGAAACTAGT|GCCCGTTTTCCACAATCCGTCTAAACCGAT
GGTAGAGATCGTGGAACCGTCAAAAGAACT|TGATAGGCGGAAACTAGTTCAGTTCGAATT
AAAATAGATATGTGCCCGTTTTCCACAATC|CCAGGATTACGTCGAGTCAGTGCCCCTCAT
CGACCAGGATTACGTCGAGTCAGTGCCCCT|TCGTTCGCATATCGTTTCGCAGAGGGTGCG
TTCCTCTAGGCTGAAAGACGGCGAGACCGG|GTGCCCCTCATGATAGGCGGAAACTAGTGT
GCGACACTGGAATCTATGCCTAGACGGGAA|ATGATAGGCGGAAACTAGTGAGTAATTCCT
CACCCGACCTGTGGAGAAGTGGCCAATCCT|AGGCGGAAACTAGTGCGTCAGTGCCCCTCA
GTGCCCCTCATGATAGGCGGAAACTAGTAA|GGAACCGTCAAAAGAACTCAATTACTTTCG
ATGATAGGCGGAAACTAGTTGCGAAGGTTC|GGCGGAAACTAGTGAGCCCAAATATCAGTG
CTCTAAAGGCCAGACAGTGCAGTGCCCCTC|ATCATGAAAATAGATATGTGCCCGTTTTCC
CAGTGCCCCTCATGATAGGCGGAAACTAGT|CCAGCTGTCTTTTTGCCCAATCAGTCAGCT
AAACTAGTCCCCTCATGATAGGCGGAAACT|AAACCGATCTACTACTAGCATCTCCGCAAG
GATCCCACCAACCCGTGGGGCCACCCTAAC|TTCCTTAGGTACCGCACAGCCCACGCTACC
GTGCCCCTCATGATAGGCGGAAACTAGTGC|GCAGTGCCCCTCATGATAGGCGGAAACTAG
GGAAACTAGTAAGTTGCTTCGACCAGACCG|GACCTGTGGAGAAGTGGCCAATCCTTCGAC
ACCGAAAAATTCCAAGCTGTCCTGTCTTAG|GCTAGGTGGTATCTTGAGAAACGGACTGGG
CCTAGACGGGAAAGTGCTTACCGAAAAATT|TGAGTAATTCCTCGAGGCAGCTAGGTGGTA
GGCTCAAAGTTCTGACCCAGTTGGAACGTT|CTTAGGGATGCGAGACGAAGATCTGTAACA
CCCTCATGATAGGCGGAAACTAGTTCAGTT|CGACAAGGACGCGGGTCTCTTCCATTCGAG
GTGATAGCCGGATGGTAGAGATCGTGGAAC|ACAGTGCCCCTCATGATAGGCGGAAACTAG
TCTATCATGAAAATAGATATGTGCCCGTTT|CACGATCGACCAGGATTACGTCGAGTCAGT
CAGATCCCACCAACCCGTGGGGCCACCCTA|TATTCCTTAGGTACCGCACAGCCCACGCTA
CGAGGGAAGGCTCAGTGCCCCTCATGATAG|CTGGAATCTATGCCTAGACGGGAAAGTGCT
CCGGATGGTAGAGATCGTGGAACCGTCAAA|CCCTCATGATAGGCGGAAACTAGTTCAGTT
TCCGTCTAAACCGATCTACTACTAGCATCT|ATGATAGGCGGAAACTAGTGGGAGGCGTAG
GCCCACGCTACCGCAGTGCCCCTCATGATA|CAGTGCCCCTCATGATAGGCGGAAACTAGT
AAGTCGACGCTCAGAGGCTCAAAGTTCTGA|GAGCCTAGGTCGCATCTTAGGGATGCGAGA
CGAAAACGCCCCGTTGCGATACAATCGCGT|GATAGGCGGAAACTAGTAAGTTGCTTCGAC
GCCAGACAGTGCAGTGCCCCTCATGATAGG|AATAGATATGTGCCCGTTTTCCACAATCCG
TTGGTCCCGACACGATCGACCAGGATTACG|AGGAAGTCGGACGATCTCGTTCGCATATCG
ATTCCAAGCTGTCCTGTCTTAGAGAAGAGC|GTATCTTGAGAAACGGACTGGGGGTAGGTT
GCGGAAACTAGTAAACTAGTGATAGCCGGA|CTGTCTTAGAGAAGAGCGACAGTGCCCCTC
GCTTAGATCACTGAAACCATTTCACTTGTC|CCCTAACTATACGGTTTCTATTCGTGGCGA
CGGAAACTAGTTGTACAGTGCCCCTCATGA|TCTAAAGGCCAGACAGTGCAGTGCCCCTCA
TCACTGAAACCATTTCACTTGTCTAAGATT|TATACGGTTTCTATTCGTGGCGAGAGACTG
TTTCTATTCGTGGCGAGAGACTGTATGGGC|CCCTCATGATAGGCGGAAACTAGTTAGGCA
CCCCTCATGATAGGCGGAAACTAGTGAGCC|CTACTACTAGCATCTCCGCAAGTCGACGCT
GGCGGAAACTAGTCCCCTCATGATAGGCGG|CGTCTAAACCGATCTACTACTAGCATCTCC
CTAGACGGGAAAGTGCTTACCGAAAAATTC|GAGTAATTCCTCGAGGCAGCTAGGTGGTAT
GTTTTCCACAATCCGTCTAAACCGATCTAC|CAGTGCCCCTCATGATAGGCGGAAACTAGT
CTCTTCCATTCGAGCACAGCCCAGCTGTCT|AAAACGCCCCGTTGCGATACAATCGCGTGT
GAAAACGCCCCGTTGCGATACAATCGCGTG|ATAGGCGGAAACTAGTAAGTTGCTTCGACC
AAGTGGCCAATCCTTCGACGGAACATTCTG|GTCAGTGCCCCTCATGATAGGCGGAAACTA
TTTTGGTCCCGACACGATCGACCAGGATTA|ACAGGAAGTCGGACGATCTCGTTCGCATAT
GCGGAAACTAGTCCCCTCATGATAGGCGGA|GTCTAAACCGATCTACTACTAGCATCTCCG
GGCGGAAACTAGTGAGTAATTCCTCGAGGC|CAATCAGTCAGCTGTTAGGTCCTTCCTCCG
AGGTACCGCACAGCCCACGCTACCGCAGTG|CCCCTCATGATACAGTGCCCCTCATGATAG
CGCGTGTAAACGCTCTTCTGTAACCAGATC|TCGACCAGACCGGGCACCCGGAACTATTCC
ACTTCCCACCCGACCTGTGGAGAAGTGGCC|CATGATAGGCGGAAACTAGTGCGTCAGTGC
ATTACGTCGAGTCAGTGCCCCTCATGATAG|ATATCGTTTCGCAGAGGGTGCGGGAGCTCC
CGAGAGACTGTATGGGCAGTGCCCCTCATG|CGGAAACTAGTTAGGCAGAACTGGAACTTC
TAGATATGTGCCCGTTTTCCACAATCCGTC|GATTACGTCGAGTCAGTGCCCCTCATGATA
CGAATTCAGTGCCCCTCATGATAGGCGGAA|CACAGCCCAGCTGTCTTTTTGCCCAATCAG
TACAATCGCGTGTAAACGCTCTTCTGTAAC|GTTGCTTCGACCAGACCGGGCACCCGGAAC
CTCCAGTGCCCCTCATGATACAGTGCCCCT|TTGCGAAGGTTCCTCTAGGCTGAAAGACGG
CTTAGGTACCGCACAGCCCACGCTACCGCA|GTGCCCCTCATGATACAGTGCCCCTCATGA
CTTTTGTTCTATCATGAAAATAGATATGTG|GTCCCGACACGATCGACCAGGATTACGTCG
CGGCAGTGCCCCTCATGATAGGCGGAAACT|ACCGAAAAATTCCAAGCTGTCCTGTCTTAG
GATAGGCGGAAACTAGTGAGCCCAAATATC|AGCATCTCCGCAAGTCGACGCTCAGAGGCT
GACTGTATGGGCAGTGCCCCTCATGATAGG|ACTAGTTAGGCAGAACTGGAACTTCCCACC
AGTTGCGAAGGTTCCTCTAGGCTGAAAGAC|CCCAAATATCAGTGCCCCTCATGATAGGCG
ATCCTTCGACGGAACATTCTGACTCCAGTG|CCTCATGATAGGCGGAAACTAGTTGCGAAG
TGCCCCTCATGATAGGCGGAAACTAGTGGC|AAGACGGCGAGACCGGTGGATATGGTTGCT
CCGACACGATCGACCAGGATTACGTCGAGT|TCGGACGATCTCGTTCGCATATCGTTTCGC
ACTAGTTGTACAGTGCCCCTCATGATAGGC|AGGCCAGACAGTGCAGTGCCCCTCATGATA
TCATGATAGGCGGAAACTAGTCCCCTCATG|CCACAATCCGTCTAAACCGATCTACTACTA
ACTAGTTGCGAAGGTTCCTCTAGGCTGAAA|GAGCCCAAATATCAGTGCCCCTCATGATAG
TCTCCGCAAGTCGACGCTCAGAGGCTCAAA|TAGTGCAGAGCCTAGGTCGCATCTTAGGGA
AAAGAACTCAATTACTTTCGCGACACTGGA|TTCGAATTCAGTGCCCCTCATGATAGGCGG
CACCCTAACTATACGGTTTCTATTCGTGGC|CACGCTACCGCAGTGCCCCTCATGATAGGC
AGCCCACGCTACCGCAGTGCCCCTCATGAT|ACAGTGCCCCTCATGATAGGCGGAAACTAG
CGTCTAAACCGATCTACTACTAGCATCTCC|GATAGGCGGAAACTAGTGGGAGGCGTAGTG
GGAAACTAGTTAGGCAGAACTGGAACTTCC|GGAAACTAGTTGTACAGTGCCCCTCATGAT
TAGGCGGAAACTAGTGTATCTTTTGTTCTA|AGTTGGAACGTTGGTTTTGGTCCCGACACG
GGAAACTAGTAAAAAGGCGAGGGAAGGCTC|CAATTACTTTCGCGACACTGGAATCTATGC
CCCGTTTTCCACAATCCGTCTAAACCGATC|AGTCAGTGCCCCTCATGATAGGCGGAAACT
CCTCATGATACAGTGCCCCTCATGATAGGC|TCCTCTAGGCTGAAAGACGGCGAGACCGGT
CATGATAGGCGGAAACTAGTGAGTAATTCC|TTTTGCCCAATCAGTCAGCTGTTAGGTCCT
GCCCAAATATCAGTGCCCCTCATGATAGGC|GCTCAGAGGCTCAAAGTTCTGACCCAGTTG
GAGAAGTGGCCAATCCTTCGACGGAACATT|TGCGTCAGTGCCCCTCATGATAGGCGGAAA
TGCCCCTCATGATACAGTGCCCCTCATGAT|AGGTTCCTCTAGGCTGAAAGACGGCGAGAC
GCCCCTCATGATAGGCGGAAACTAGTAAAA|AACCGTCAAAAGAACTCAATTACTTTCGCG
GCCACCCTAACTATACGGTTTCTATTCGTG|CCCACGCTACCGCAGTGCCCCTCATGATAG
AGGGAAGGCTCAGTGCCCCTCATGATAGGC|GGAATCTATGCCTAGACGGGAAAGTGCTTA
GAACATTCTGACTCCAGTGCCCCTCATGAT|GCGGAAACTAGTTGCGAAGGTTCCTCTAGG
AGGCGGAAACTAGTTAGGCAGAACTGGAAC|TGGCGGAAACTAGTTGTACAGTGCCCCTCA
CCGTCAAAAGAACTCAATTACTTTCGCGAC|GTTCAGTTCGAATTCAGTGCCCCTCATGAT
TGATAGGCGGAAACTAGTAAGTTGCTTCGA|TCCCACCCGACCTGTGGAGAAGTGGCCAAT
TAGCCGGATGGTAGAGATCGTGGAACCGTC|TGCCCCTCATGATAGGCGGAAACTAGTTCA
TCGAGTCAGTGCCCCTCATGATAGGCGGAA|TTTCGCAGAGGGTGCGGGAGCTCCCGGGGA
ACGGAACATTCTGACTCCAGTGCCCCTCAT|TAGGCGGAAACTAGTTGCGAAGGTTCCTCT
GGAAACTAGTCCCCTCATGATAGGCGGAAA|CTAAACCGATCTACTACTAGCATCTCCGCA
AGTTCTGACCCAGTTGGAACGTTGGTTTTG|ATGCGAGACGAAGATCTGTAACAGCACAGG
ATGAAAATAGATATGTGCCCGTTTTCCACA|CGACCAGGATTACGTCGAGTCAGTGCCCCT
GAAGTGGCCAATCCTTCGACGGAACATTCT|CGTCAGTGCCCCTCATGATAGGCGGAAACT
ACTCAATTACTTTCGCGACACTGGAATCTA|ATTCAGTGCCCCTCATGATAGGCGGAAACT
GACAGTGCCCCTCATGATAGGCGGAAACTA|GACAACGCCGACAAGGACGCGGGTCTCTTC
ACGCCGACAAGGACGCGGGTCTCTTCCATT|GCCTAAAATCCACCCCTGCGAAAACGCCCC
AAACGCTCTTCTGTAACCAGATCCCACCAA|GACCGGGCACCCGGAACTATTCCTTAGGTA
TCAAAGTTCTGACCCAGTTGGAACGTTGGT|AGGGATGCGAGACGAAGATCTGTAACAGCA
GTAGGTTGACAACGCCGACAAGGACGCGGG|GTCTAAGATTAGCCTAAAATCCACCCCTGC
GTCTTAGAGAAGAGCGACAGTGCCCCTCAT|GACTGGGGGTAGGTTGACAACGCCGACAAG
CGGGCACCCGGAACTATTCCTTAGGTACCG|ACGGAACATTCTGACTCCAGTGCCCCTCAT
TTCCACAATCCGTCTAAACCGATCTACTAC|TGCCCCTCATGATAGGCGGAAACTAGTGGG
GACCGGGCACCCGGAACTATTCCTTAGGTA|TCGACGGAACATTCTGACTCCAGTGCCCCT
GTGCCCCTCATGATAGGCGGAAACTAGTTC|ACGCCGACAAGGACGCGGGTCTCTTCCATT
ATAGGCGGAAACTAGTCCCCTCATGATAGG|ATCCGTCTAAACCGATCTACTACTAGCATC
TATCTTGAGAAACGGACTGGGGGTAGGTTG|GATCACTGAAACCATTTCACTTGTCTAAGA
GGTTTTGGTCCCGACACGATCGACCAGGAT|GCACAGGAAGTCGGACGATCTCGTTCGCAT
GGCGGAAACTAGTGAGCCCAAATATCAGTG|TCTCCGCAAGTCGACGCTCAGAGGCTCAAA
TGTGGAGAAGTGGCCAATCCTTCGACGGAA|CTAGTGCGTCAGTGCCCCTCATGATAGGCG
AAGGCTCAGTGCCCCTCATGATAGGCGGCA|TCTATGCCTAGACGGGAAAGTGCTTACCGA
ATCTTGAGAAACGGACTGGGGGTAGGTTGA|ATCACTGAAACCATTTCACTTGTCTAAGAT
CGCCGAAGCTTAGATCACTGAAACCATTTC|GGGGCCACCCTAACTATACGGTTTCTATTC
TTCAGTTCGAATTCAGTGCCCCTCATGATA|ATTCGAGCACAGCCCAGCTGTCTTTTTGCC
TGCCCAATCAGTCAGCTGTTAGGTCCTTCC|CGCTCTTCTGTAACCAGATCCCACCAACCC
TAGGCGGAAACTAGTGAGTAATTCCTCGAG|CCCAATCAGTCAGCTGTTAGGTCCTTCCTC
TCTGTAACCAGATCCCACCAACCCGTGGGG|CCCGGAACTATTCCTTAGGTACCGCACAGC
GCCCCTCATGATAGGCGGAAACTAGTTGCG|CATGATAGGCGGAAACTAGTGAGCCCAAAT
TGCTTCGACCAGACCGGGCACCCGGAACTA|TGGCCAATCCTTCGACGGAACATTCTGACT
CCGACAAGGACGCGGGTCTCTTCCATTCGA|TAAAATCCACCCCTGCGAAAACGCCCCGTT
CATTCTGACTCCAGTGCCCCTCATGATACA|GAAACTAGTTGCGAAGGTTCCTCTAGGCTG
TGCCCCTCATGATAGGCGGAAACTAGTGTA|AAGTTCTGACCCAGTTGGAACGTTGGTTTT
TAGGCGGAAACTAGTGAGCCCAAATATCAG|CATCTCCGCAAGTCGACGCTCAGAGGCTCA
TACGGTTTCTATTCGTGGCGAGAGACTGTA|AGTGCCCCTCATGATAGGCGGAAACTAGTT
CCTCATGATAGGCGGAAACTAGTTGCGAAG|GATAGGCGGAAACTAGTGAGCCCAAATATC
AGTTGTACAGTGCCCCTCATGATAGGCGGA|CCAGACAGTGCAGTGCCCCTCATGATAGGC
ACGGGAAAGTGCTTACCGAAAAATTCCAAG|AATTCCTCGAGGCAGCTAGGTGGTATCTTG
AACTAGTGAGCCCAAATATCAGTGCCCCTC|CAAGTCGACGCTCAGAGGCTCAAAGTTCTG
AGGTTCCTCTAGGCTGAAAGACGGCGAGAC|TCAGTGCCCCTCATGATAGGCGGAAACTAG
CCCCTCATGATAGGCGGAAACTAGTGGCGG|GACGGCGAGACCGGTGGATATGGTTGCTCT
CTAAGATTAGCCTAAAATCCACCCCTGCGA|AGAGACTGTATGGGCAGTGCCCCTCATGAT
CACCCCTGCGAAAACGCCCCGTTGCGATAC|CCCCTCATGATAGGCGGAAACTAGTAAGTT
ACTAGTAAAAAGGCGAGGGAAGGCTCAGTG|TACTTTCGCGACACTGGAATCTATGCCTAG
TGACTCCAGTGCCCCTCATGATACAGTGCC|TAGTTGCGAAGGTTCCTCTAGGCTGAAAGA
CTCATGATAGGCGGAAACTAGTTAGGCAGA|GAAACTAGTGGCGGAAACTAGTTGTACAGT
ACGTTGGTTTTGGTCCCGACACGATCGACC|TAACAGCACAGGAAGTCGGACGATCTCGTT
GGAACCGTCAAAAGAACTCAATTACTTTCG|ACTAGTTCAGTTCGAATTCAGTGCCCCTCA
CTCATGATAGGCGGAAACTAGTAAAAAGGC|GTCAAAAGAACTCAATTACTTTCGCGACAC
AGAGGCTCAAAGTTCTGACCCAGTTGGAAC|CATCTTAGGGATGCGAGACGAAGATCTGTA
ATGATAGGCGGAAACTAGTAAAAAGGCGAG|AAAAGAACTCAATTACTTTCGCGACACTGG
ACTAGTGTATCTTTTGTTCTATCATGAAAA|GTTGGTTTTGGTCCCGACACGATCGACCAG
AACATTCTGACTCCAGTGCCCCTCATGATA|CGGAAACTAGTTGCGAAGGTTCCTCTAGGC
AGGCGGAAACTAGTGAGTAATTCCTCGAGG|CCAATCAGTCAGCTGTTAGGTCCTTCCTCC
GATAGGCGGAAACTAGTGTATCTTTTGTTC|CCAGTTGGAACGTTGGTTTTGGTCCCGACA
CTTCTGTAACCAGATCCCACCAACCCGTGG|CACCCGGAACTATTCCTTAGGTACCGCACA
GTGCCCCTCATGATAGGCGGAAACTAGTGA|AGCTGTCTTTTTGCCCAATCAGTCAGCTGT
AGGCGGAAACTAGTAAACTAGTGATAGCCG|TCCTGTCTTAGAGAAGAGCGACAGTGCCCC
AACTCAATTACTTTCGCGACACTGGAATCT|AATTCAGTGCCCCTCATGATAGGCGGAAAC
GAGAGACTGTATGGGCAGTGCCCCTCATGA|GGAAACTAGTTAGGCAGAACTGGAACTTCC
AGTAATTCCTCGAGGCAGCTAGGTGGTATC|TTAGGTCCTTCCTCCGCCGAAGCTTAGATC
GGCGGAAACTAGTGCGTCAGTGCCCCTCAT|ATAGGCGGAAACTAGTCCCCTCATGATAGG
AATTACTTTCGCGACACTGGAATCTATGCC|AGTGCCCCTCATGATAGGCGGAAACTAGTG
GCTCTAAAGGCCAGACAGTGCAGTGCCCCT|TATCATGAAAATAGATATGTGCCCGTTTTC
CGGAAACTAGTGAGTAATTCCTCGAGGCAG|ATCAGTCAGCTGTTAGGTCCTTCCTCCGCC
GAAGGTTCCTCTAGGCTGAAAGACGGCGAG|TATCAGTGCCCCTCATGATAGGCGGAAACT
ACCGGGCACCCGGAACTATTCCTTAGGTAC|CGACGGAACATTCTGACTCCAGTGCCCCTC
CACAATCCGTCTAAACCGATCTACTACTAG|CCCTCATGATAGGCGGAAACTAGTGGGAGG
AAAATTCCAAGCTGTCCTGTCTTAGAGAAG|GTGGTATCTTGAGAAACGGACTGGGGGTAG
CGGAAACTAGTGCGTCAGTGCCCCTCATGA|AGGCGGAAACTAGTCCCCTCATGATAGGCG
GGAACTATTCCTTAGGTACCGCACAGCCCA|TCTGACTCCAGTGCCCCTCATGATACAGTG
TAGGCGGAAACTAGTAAACTAGTGATAGCC|GTCCTGTCTTAGAGAAGAGCGACAGTGCCC
ACCGGTGGATATGGTTGCTCTAAAGGCCAG|AGTGTATCTTTTGTTCTATCATGAAAATAG
ACCGCACAGCCCACGCTACCGCAGTGCCCC|TCATGATACAGTGCCCCTCATGATAGGCGG
GAACTATTCCTTAGGTACCGCACAGCCCAC|CTGACTCCAGTGCCCCTCATGATACAGTGC
AAGCTTAGATCACTGAAACCATTTCACTTG|CACCCTAACTATACGGTTTCTATTCGTGGC
ACGCTCAGAGGCTCAAAGTTCTGACCCAGT|AGGTCGCATCTTAGGGATGCGAGACGAAGA
TGTTAGGTCCTTCCTCCGCCGAAGCTTAGA|GATCCCACCAACCCGTGGGGCCACCCTAAC
AGTGCGTCAGTGCCCCTCATGATAGGCGGA|ACTAGTCCCCTCATGATAGGCGGAAACTAG
CAATCAGTCAGCTGTTAGGTCCTTCCTCCG|CTTCTGTAACCAGATCCCACCAACCCGTGG
GTGGAACCGTCAAAAGAACTCAATTACTTT|AAACTAGTTCAGTTCGAATTCAGTGCCCCT
AGTGTATCTTTTGTTCTATCATGAAAATAG|GGTTTTGGTCCCGACACGATCGACCAGGAT
CTACCGCAGTGCCCCTCATGATAGGCGGAA|CCTCATGATAGGCGGAAACTAGTGGCGGAA
GTATCTTGAGAAACGGACTGGGGGTAGGTT|AGATCACTGAAACCATTTCACTTGTCTAAG
AAGTTCTGACCCAGTTGGAACGTTGGTTTT|GATGCGAGACGAAGATCTGTAACAGCACAG
CCCCTCATGATAGGCGGAAACTAGTGTATC|GTTCTGACCCAGTTGGAACGTTGGTTTTGG
TCCTGTCTTAGAGAAGAGCGACAGTGCCCC|AACGGACTGGGGGTAGGTTGACAACGCCGA
GTGCTTACCGAAAAATTCCAAGCTGTCCTG|GAGGCAGCTAGGTGGTATCTTGAGAAACGG
TCCTTCGACGGAACATTCTGACTCCAGTGC|CTCATGATAGGCGGAAACTAGTTGCGAAGG
TATGGGCAGTGCCCCTCATGATAGGCGGAA|TTAGGCAGAACTGGAACTTCCCACCCGACC
GGAAACTAGTGGCGGAAACTAGTTGTACAG|GGATATGGTTGCTCTAAAGGCCAGACAGTG
GGCACCCGGAACTATTCCTTAGGTACCGCA|GGAACATTCTGACTCCAGTGCCCCTCATGA
TAGGTGGTATCTTGAGAAACGGACTGGGGG|AAGCTTAGATCACTGAAACCATTTCACTTG
ACCCGGAACTATTCCTTAGGTACCGCACAG|ACATTCTGACTCCAGTGCCCCTCATGATAC
CTGAAACCATTTCACTTGTCTAAGATTAGC|ACGGTTTCTATTCGTGGCGAGAGACTGTAT
AAAGTGCTTACCGAAAAATTCCAAGCTGTC|CTCGAGGCAGCTAGGTGGTATCTTGAGAAA
CCTCATGATAGGCGGAAACTAGTGTATCTT|TCTGACCCAGTTGGAACGTTGGTTTTGGTC
TTCTATCATGAAAATAGATATGTGCCCGTT|ACACGATCGACCAGGATTACGTCGAGTCAG
TCGCGACACTGGAATCTATGCCTAGACGGG|TCATGATAGGCGGAAACTAGTGAGTAATTC
AAAAAGGCGAGGGAAGGCTCAGTGCCCCTC|CGCGACACTGGAATCTATGCCTAGACGGGA
CGACCAGACCGGGCACCCGGAACTATTCCT|AATCCTTCGACGGAACATTCTGACTCCAGT
TAGTAAAAAGGCGAGGGAAGGCTCAGTGCC|CTTTCGCGACACTGGAATCTATGCCTAGAC
TGCCCCTCATGATAGGCGGAAACTAGTTCA|CGCCGACAAGGACGCGGGTCTCTTCCATTC
TGGTTTTGGTCCCGACACGATCGACCAGGA|AGCACAGGAAGTCGGACGATCTCGTTCGCA
GTGCCCCTCATGATAGGCGGAAACTAGTGG|AAAGACGGCGAGACCGGTGGATATGGTTGC
CCAGTGCCCCTCATGATACAGTGCCCCTCA|GCGAAGGTTCCTCTAGGCTGAAAGACGGCG
TACTAGCATCTCCGCAAGTCGACGCTCAGA|GGGAGGCGTAGTGCAGAGCCTAGGTCGCAT
TAGACGGGAAAGTGCTTACCGAAAAATTCC|AGTAATTCCTCGAGGCAGCTAGGTGGTATC
CCGGAACTATTCCTTAGGTACCGCACAGCC|ATTCTGACTCCAGTGCCCCTCATGATACAG
CTTCCATTCGAGCACAGCCCAGCTGTCTTT|AACGCCCCGTTGCGATACAATCGCGTGTAA
AGGCTCAAAGTTCTGACCCAGTTGGAACGT|TCTTAGGGATGCGAGACGAAGATCTGTAAC
TATGGTTGCTCTAAAGGCCAGACAGTGCAG|TTTGTTCTATCATGAAAATAGATATGTGCC
AGGTCCTTCCTCCGCCGAAGCTTAGATCAC|CCACCAACCCGTGGGGCCACCCTAACTATA
CTAGTGATAGCCGGATGGTAGAGATCGTGG|GCGACAGTGCCCCTCATGATAGGCGGAAAC
AACGCCGACAAGGACGCGGGTCTCTTCCAT|AGCCTAAAATCCACCCCTGCGAAAACGCCC
CATGATAGGCGGAAACTAGTGCGTCAGTGC|CCTCATGATAGGCGGAAACTAGTCCCCTCA
CCCCTCATGATACAGTGCCCCTCATGATAG|GTTCCTCTAGGCTGAAAGACGGCGAGACCG
AACTAGTTCAGTTCGAATTCAGTGCCCCTC|TCTTCCATTCGAGCACAGCCCAGCTGTCTT
GATAGGCGGAAACTAGTTAGGCAGAACTGG|TAGTGGCGGAAACTAGTTGTACAGTGCCCC
TAGGCGGAAACTAGTTGCGAAGGTTCCTCT|GAAACTAGTGAGCCCAAATATCAGTGCCCC
ACCCTAACTATACGGTTTCTATTCGTGGCG|ACGCTACCGCAGTGCCCCTCATGATAGGCG
CTGACTCCAGTGCCCCTCATGATACAGTGC|CTAGTTGCGAAGGTTCCTCTAGGCTGAAAG
AGTGCAGTGCCCCTCATGATAGGCGGAAAC|ATGTGCCCGTTTTCCACAATCCGTCTAAAC
TGTGCCCGTTTTCCACAATCCGTCTAAACC|GTCGAGTCAGTGCCCCTCATGATAGGCGGA
TCCTCCGCCGAAGCTTAGATCACTGAAACC|CCCGTGGGGCCACCCTAACTATACGGTTTC
TGCGAAAACGCCCCGTTGCGATACAATCGC|ATGATAGGCGGAAACTAGTAAGTTGCTTCG
GGAACTTCCCACCCGACCTGTGGAGAAGTG|CCTCATGATAGGCGGAAACTAGTGCGTCAG
TTCGACGGAACATTCTGACTCCAGTGCCCC|ATGATAGGCGGAAACTAGTTGCGAAGGTTC
CCCACGCTACCGCAGTGCCCCTCATGATAG|AGTGCCCCTCATGATAGGCGGAAACTAGTG
TTACTTTCGCGACACTGGAATCTATGCCTA|TGCCCCTCATGATAGGCGGAAACTAGTGAG
AGGCCAGACAGTGCAGTGCCCCTCATGATA|AAAATAGATATGTGCCCGTTTTCCACAATC
GGATTACGTCGAGTCAGTGCCCCTCATGAT|GCATATCGTTTCGCAGAGGGTGCGGGAGCT
CCCCTCATGATAGGCGGAAACTAGTTAGGC|GCGGAAACTAGTGGCGGAAACTAGTTGTAC
TACAGTGCCCCTCATGATAGGCGGAAACTA|GCTGAAAGACGGCGAGACCGGTGGATATGG
TCAGTCAGCTGTTAGGTCCTTCCTCCGCCG|CTGTAACCAGATCCCACCAACCCGTGGGGC
CGCCCCGTTGCGATACAATCGCGTGTAAAC|CGGAAACTAGTAAGTTGCTTCGACCAGACC
TCTTCTGTAACCAGATCCCACCAACCCGTG|GCACCCGGAACTATTCCTTAGGTACCGCAC
CGGTGGATATGGTTGCTCTAAAGGCCAGAC|TGTATCTTTTGTTCTATCATGAAAATAGAT
TGCCCCTCATGATAGGCGGAAACTAGTAAA|AAATTCCAAGCTGTCCTGTCTTAGAGAAGA
ATAGCCGGATGGTAGAGATCGTGGAACCGT|GTGCCCCTCATGATAGGCGGAAACTAGTTC
CCCTCATGATAGGCGGAAACTAGTTAGGCA|CGGAAACTAGTGGCGGAAACTAGTTGTACA
ACCGCAGTGCCCCTCATGATAGGCGGAAAC|TCATGATAGGCGGAAACTAGTGGCGGAAAC
AAACTAGTGATAGCCGGATGGTAGAGATCG|AGAGCGACAGTGCCCCTCATGATAGGCGGA
CTGAAAGACGGCGAGACCGGTGGATATGGT|TGATAGGCGGAAACTAGTGTATCTTTTGTT
AGGCGGAAACTAGTGAGCCCAAATATCAGT|ATCTCCGCAAGTCGACGCTCAGAGGCTCAA
GCAAGTCGACGCTCAGAGGCTCAAAGTTCT|CAGAGCCTAGGTCGCATCTTAGGGATGCGA
AGTGCCCCTCATGATAGGCGGAAACTAGTG|CAGCTGTCTTTTTGCCCAATCAGTCAGCTG
AAACTAGTGTATCTTTTGTTCTATCATGAA|ACGTTGGTTTTGGTCCCGACACGATCGACC
GTCGAGTCAGTGCCCCTCATGATAGGCGGA|GTTTCGCAGAGGGTGCGGGAGCTCCCGGGG
GACAAGGACGCGGGTCTCTTCCATTCGAGC|AAATCCACCCCTGCGAAAACGCCCCGTTGC
CATGATACAGTGCCCCTCATGATAGGCGGA|TCTAGGCTGAAAGACGGCGAGACCGGTGGA
ACGCTACCGCAGTGCCCCTCATGATAGGCG|GCCCCTCATGATAGGCGGAAACTAGTGGCG
GTCTAAGATTAGCCTAAAATCCACCCCTGC|CGAGAGACTGTATGGGCAGTGCCCCTCATG
GACAACGCCGACAAGGACGCGGGTCTCTTC|ATTAGCCTAAAATCCACCCCTGCGAAAACG
TAGTGATAGCCGGATGGTAGAGATCGTGGA|CGACAGTGCCCCTCATGATAGGCGGAAACT
GGTGGATATGGTTGCTCTAAAGGCCAGACA|GTATCTTTTGTTCTATCATGAAAATAGATA
TAAGTTGCTTCGACCAGACCGGGCACCCGG|AGAAGTGGCCAATCCTTCGACGGAACATTC
CGGAAACTAGTAAACTAGTGATAGCCGGAT|TGTCTTAGAGAAGAGCGACAGTGCCCCTCA
TCGAGGCAGCTAGGTGGTATCTTGAGAAAC|TCCTCCGCCGAAGCTTAGATCACTGAAACC
CCCCGTTGCGATACAATCGCGTGTAAACGC|GAAACTAGTAAGTTGCTTCGACCAGACCGG
AGAACTCAATTACTTTCGCGACACTGGAAT|CGAATTCAGTGCCCCTCATGATAGGCGGAA
ACCCCTGCGAAAACGCCCCGTTGCGATACA|CCCTCATGATAGGCGGAAACTAGTAAGTTG
CATGATAGGCGGAAACTAGTGGCGGAAACT|CGAGACCGGTGGATATGGTTGCTCTAAAGG
TCATGATAGGCGGAAACTAGTAAACTAGTG|CAAGCTGTCCTGTCTTAGAGAAGAGCGACA
GGTGGTATCTTGAGAAACGGACTGGGGGTA|GCTTAGATCACTGAAACCATTTCACTTGTC
CGCCGACAAGGACGCGGGTCTCTTCCATTC|CCTAAAATCCACCCCTGCGAAAACGCCCCG
GACACGATCGACCAGGATTACGTCGAGTCA|GGACGATCTCGTTCGCATATCGTTTCGCAG
GATAGGCGGAAACTAGTGGCGGAAACTAGT|GACCGGTGGATATGGTTGCTCTAAAGGCCA
GACGCGGGTCTCTTCCATTCGAGCACAGCC|ACCCCTGCGAAAACGCCCCGTTGCGATACA
GGAACATTCTGACTCCAGTGCCCCTCATGA|GGCGGAAACTAGTTGCGAAGGTTCCTCTAG
GCGGGTCTCTTCCATTCGAGCACAGCCCAG|CCTGCGAAAACGCCCCGTTGCGATACAATC
CCGAAGCTTAGATCACTGAAACCATTTCAC|GGCCACCCTAACTATACGGTTTCTATTCGT
CTCATGATACAGTGCCCCTCATGATAGGCG|CCTCTAGGCTGAAAGACGGCGAGACCGGTG
CGACAAGGACGCGGGTCTCTTCCATTCGAG|AAAATCCACCCCTGCGAAAACGCCCCGTTG
TCTATTCGTGGCGAGAGACTGTATGGGCAG|CTCATGATAGGCGGAAACTAGTTAGGCAGA
CAGTGCCCCTCATGATAGGCGGCAGTGCCC|CCTAGACGGGAAAGTGCTTACCGAAAAATT
CGCAGTGCCCCTCATGATAGGCGGAAACTA|ATGATAGGCGGAAACTAGTGGCGGAAACTA
CGGAAACTAGTGTATCTTTTGTTCTATCAT|GGAACGTTGGTTTTGGTCCCGACACGATCG
CGGAAACTAGTTGCGAAGGTTCCTCTAGGC|CTAGTGAGCCCAAATATCAGTGCCCCTCAT
TACTACTAGCATCTCCGCAAGTCGACGCTC|AGTGGGAGGCGTAGTGCAGAGCCTAGGTCG
GAGACCGGTGGATATGGTTGCTCTAAAGGC|ACTAGTGTATCTTTTGTTCTATCATGAAAA
TAGTGGCGGAAACTAGTTGTACAGTGCCCC|GGTTGCTCTAAAGGCCAGACAGTGCAGTGC
TCTTGAGAAACGGACTGGGGGTAGGTTGAC|TCACTGAAACCATTTCACTTGTCTAAGATT
ATGATAGGCGGAAACTAGTGTATCTTTTGT|ACCCAGTTGGAACGTTGGTTTTGGTCCCGA
AACCCGTGGGGCCACCCTAACTATACGGTT|TACCGCACAGCCCACGCTACCGCAGTGCCC
GATAGGCGGAAACTAGTCCCCTCATGATAG|AATCCGTCTAAACCGATCTACTACTAGCAT
TTGCTTCGACCAGACCGGGCACCCGGAACT|GTGGCCAATCCTTCGACGGAACATTCTGAC
ATCAGTCAGCTGTTAGGTCCTTCCTCCGCC|TCTGTAACCAGATCCCACCAACCCGTGGGG
TCGAATTCAGTGCCCCTCATGATAGGCGGA|GCACAGCCCAGCTGTCTTTTTGCCCAATCA
CCTCATGATAGGCGGAAACTAGTCCCCTCA|TTCCACAATCCGTCTAAACCGATCTACTAC
CCGATCTACTACTAGCATCTCCGCAAGTCG|GAAACTAGTGGGAGGCGTAGTGCAGAGCCT
TTCCTCCGCCGAAGCTTAGATCACTGAAAC|ACCCGTGGGGCCACCCTAACTATACGGTTT
AGACTGTATGGGCAGTGCCCCTCATGATAG|AACTAGTTAGGCAGAACTGGAACTTCCCAC
AAAGTTCTGACCCAGTTGGAACGTTGGTTT|GGATGCGAGACGAAGATCTGTAACAGCACA
CGGTTTCTATTCGTGGCGAGAGACTGTATG|TGCCCCTCATGATAGGCGGAAACTAGTTAG
CTAGTCCCCTCATGATAGGCGGAAACTAGT|CCGATCTACTACTAGCATCTCCGCAAGTCG
CTGACCCAGTTGGAACGTTGGTTTTGGTCC|GAGACGAAGATCTGTAACAGCACAGGAAGT
AATTCAGTGCCCCTCATGATAGGCGGAAAC|CAGCCCAGCTGTCTTTTTGCCCAATCAGTC
CTAGTAAGTTGCTTCGACCAGACCGGGCAC|GTGGAGAAGTGGCCAATCCTTCGACGGAAC
CTTGAGAAACGGACTGGGGGTAGGTTGACA|CACTGAAACCATTTCACTTGTCTAAGATTA
TCAATTACTTTCGCGACACTGGAATCTATG|TCAGTGCCCCTCATGATAGGCGGAAACTAG
CGGAAACTAGTCCCCTCATGATAGGCGGAA|TCTAAACCGATCTACTACTAGCATCTCCGC
AAACTAGTTGTACAGTGCCCCTCATGATAG|AAAGGCCAGACAGTGCAGTGCCCCTCATGA
AGGCTCAGTGCCCCTCATGATAGGCGGCAG|CTATGCCTAGACGGGAAAGTGCTTACCGAA
CCCCTGCGAAAACGCCCCGTTGCGATACAA|CCTCATGATAGGCGGAAACTAGTAAGTTGC
GCTACCGCAGTGCCCCTCATGATAGGCGGA|CCCTCATGATAGGCGGAAACTAGTGGCGGA
TTGACAACGCCGACAAGGACGCGGGTCTCT|AGATTAGCCTAAAATCCACCCCTGCGAAAA
TAGCATCTCCGCAAGTCGACGCTCAGAGGC|AGGCGTAGTGCAGAGCCTAGGTCGCATCTT
CCTGCGAAAACGCCCCGTTGCGATACAATC|TCATGATAGGCGGAAACTAGTAAGTTGCTT
CTCATGATAGGCGGAAACTAGTGAGCCCAA|CTACTAGCATCTCCGCAAGTCGACGCTCAG
TTTTCCACAATCCGTCTAAACCGATCTACT|AGTGCCCCTCATGATAGGCGGAAACTAGTG
GTGCCCCTCATGATAGGCGGCAGTGCCCCT|TAGACGGGAAAGTGCTTACCGAAAAATTCC
GCTTACCGAAAAATTCCAAGCTGTCCTGTC|GGCAGCTAGGTGGTATCTTGAGAAACGGAC
TAGTGTATCTTTTGTTCTATCATGAAAATA|TGGTTTTGGTCCCGACACGATCGACCAGGA
GCACCCGGAACTATTCCTTAGGTACCGCAC|GAACATTCTGACTCCAGTGCCCCTCATGAT
ACCATTTCACTTGTCTAAGATTAGCCTAAA|TTCTATTCGTGGCGAGAGACTGTATGGGCA
AGATATGTGCCCGTTTTCCACAATCCGTCT|ATTACGTCGAGTCAGTGCCCCTCATGATAG
GCTGTCCTGTCTTAGAGAAGAGCGACAGTG|GAGAAACGGACTGGGGGTAGGTTGACAACG
AATTCCTCGAGGCAGCTAGGTGGTATCTTG|GGTCCTTCCTCCGCCGAAGCTTAGATCACT
GGGCAGTGCCCCTCATGATAGGCGGAAACT|GGCAGAACTGGAACTTCCCACCCGACCTGT
AACTAGTTGTACAGTGCCCCTCATGATAGG|AAGGCCAGACAGTGCAGTGCCCCTCATGAT
CAACCCGTGGGGCCACCCTAACTATACGGT|GTACCGCACAGCCCACGCTACCGCAGTGCC
GCCCAGCTGTCTTTTTGCCCAATCAGTCAG|ACAATCGCGTGTAAACGCTCTTCTGTAACC
CCTTAGGTACCGCACAGCCCACGCTACCGC|AGTGCCCCTCATGATACAGTGCCCCTCATG
ATATGGTTGCTCTAAAGGCCAGACAGTGCA|TTTTGTTCTATCATGAAAATAGATATGTGC
TTCACTTGTCTAAGATTAGCCTAAAATCCA|TTCGTGGCGAGAGACTGTATGGGCAGTGCC
GTTTCTATTCGTGGCGAGAGACTGTATGGG|CCCCTCATGATAGGCGGAAACTAGTTAGGC
TGGAACGTTGGTTTTGGTCCCGACACGATC|TCTGTAACAGCACAGGAAGTCGGACGATCT
ATCAGTGCCCCTCATGATAGGCGGAAACTA|GCTCAAAGTTCTGACCCAGTTGGAACGTTG
AGGCGGAAACTAGTGTATCTTTTGTTCTAT|GTTGGAACGTTGGTTTTGGTCCCGACACGA
AATCTATGCCTAGACGGGAAAGTGCTTACC|GAAACTAGTGAGTAATTCCTCGAGGCAGCT
GATATGTGCCCGTTTTCCACAATCCGTCTA|TTACGTCGAGTCAGTGCCCCTCATGATAGG
ATCGACCAGGATTACGTCGAGTCAGTGCCC|TCTCGTTCGCATATCGTTTCGCAGAGGGTG
AGAAGTGGCCAATCCTTCGACGGAACATTC|GCGTCAGTGCCCCTCATGATAGGCGGAAAC
AATCCTTCGACGGAACATTCTGACTCCAGT|CCCTCATGATAGGCGGAAACTAGTTGCGAA
CCTCATGATAGGCGGAAACTAGTGAGCCCA|ACTACTAGCATCTCCGCAAGTCGACGCTCA
GTCCCGACACGATCGACCAGGATTACGTCG|AAGTCGGACGATCTCGTTCGCATATCGTTT
GATTAGCCTAAAATCCACCCCTGCGAAAAC|ACTGTATGGGCAGTGCCCCTCATGATAGGC
AGCGACAGTGCCCCTCATGATAGGCGGAAA|GTTGACAACGCCGACAAGGACGCGGGTCTC
GCTGTTAGGTCCTTCCTCCGCCGAAGCTTA|CAGATCCCACCAACCCGTGGGGCCACCCTA
GCCCCTCATGATAGGCGGAAACTAGTGAGT|CTGTCTTTTTGCCCAATCAGTCAGCTGTTA
TGTCTAAGATTAGCCTAAAATCCACCCCTG|GCGAGAGACTGTATGGGCAGTGCCCCTCAT
AACTATACGGTTTCTATTCGTGGCGAGAGA|ACCGCAGTGCCCCTCATGATAGGCGGAAAC
AAAGGCCAGACAGTGCAGTGCCCCTCATGA|TGAAAATAGATATGTGCCCGTTTTCCACAA
GAAACTAGTGTATCTTTTGTTCTATCATGA|AACGTTGGTTTTGGTCCCGACACGATCGAC
AGCTGTCTTTTTGCCCAATCAGTCAGCTGT|TCGCGTGTAAACGCTCTTCTGTAACCAGAT
GTTCAGTTCGAATTCAGTGCCCCTCATGAT|CATTCGAGCACAGCCCAGCTGTCTTTTTGC
CCCCTCATGATAGGCGGAAACTAGTGCGTC|GTGCCCCTCATGATAGGCGGAAACTAGTCC
CCCAATCAGTCAGCTGTTAGGTCCTTCCTC|CTCTTCTGTAACCAGATCCCACCAACCCGT
TGCCCCTCATGATAGGCGGAAACTAGTCCC|CGTTTTCCACAATCCGTCTAAACCGATCTA
TATTCCTTAGGTACCGCACAGCCCACGCTA|CTCCAGTGCCCCTCATGATACAGTGCCCCT
CGCGGGTCTCTTCCATTCGAGCACAGCCCA|CCCTGCGAAAACGCCCCGTTGCGATACAAT
CTCAGAGGCTCAAAGTTCTGACCCAGTTGG|TCGCATCTTAGGGATGCGAGACGAAGATCT
ATCCGTCTAAACCGATCTACTACTAGCATC|CATGATAGGCGGAAACTAGTGGGAGGCGTA
CCATTTCACTTGTCTAAGATTAGCCTAAAA|TCTATTCGTGGCGAGAGACTGTATGGGCAG
GGGTAGGTTGACAACGCCGACAAGGACGCG|TTGTCTAAGATTAGCCTAAAATCCACCCCT
TTAGGCAGAACTGGAACTTCCCACCCGACC|TTGTACAGTGCCCCTCATGATAGGCGGAAA
TTGCCCAATCAGTCAGCTGTTAGGTCCTTC|ACGCTCTTCTGTAACCAGATCCCACCAACC
CCTCATGATAGGCGGAAACTAGTAAAAAGG|CGTCAAAAGAACTCAATTACTTTCGCGACA
AGGCAGAACTGGAACTTCCCACCCGACCTG|GTACAGTGCCCCTCATGATAGGCGGAAACT
TAAAGGCCAGACAGTGCAGTGCCCCTCATG|ATGAAAATAGATATGTGCCCGTTTTCCACA
AGAACTGGAACTTCCCACCCGACCTGTGGA|AGTGCCCCTCATGATAGGCGGAAACTAGTG
CCCCTCATGATAGGCGGAAACTAGTCCCCT|TTTTCCACAATCCGTCTAAACCGATCTACT
ATATGTGCCCGTTTTCCACAATCCGTCTAA|TACGTCGAGTCAGTGCCCCTCATGATAGGC
TCAGTGCCCCTCATGATAGGCGGCAGTGCC|GCCTAGACGGGAAAGTGCTTACCGAAAAAT
CTGGAACTTCCCACCCGACCTGTGGAGAAG|CCCCTCATGATAGGCGGAAACTAGTGCGTC
TCTACTACTAGCATCTCCGCAAGTCGACGC|CTAGTGGGAGGCGTAGTGCAGAGCCTAGGT
CCTCATGATAGGCGGAAACTAGTTCAGTTC|GACAAGGACGCGGGTCTCTTCCATTCGAGC
GTGCCCCTCATGATAGGCGGAAACTAGTTA|TAGGCGGAAACTAGTGGCGGAAACTAGTTG
TAGTTCAGTTCGAATTCAGTGCCCCTCATG|TCCATTCGAGCACAGCCCAGCTGTCTTTTT
TCTTCCATTCGAGCACAGCCCAGCTGTCTT|AAACGCCCCGTTGCGATACAATCGCGTGTA
CCCACCCGACCTGTGGAGAAGTGGCCAATC|ATAGGCGGAAACTAGTGCGTCAGTGCCCCT
ACTAGTGAGTAATTCCTCGAGGCAGCTAGG|TCAGCTGTTAGGTCCTTCCTCCGCCGAAGC
TCCTCGAGGCAGCTAGGTGGTATCTTGAGA|CCTTCCTCCGCCGAAGCTTAGATCACTGAA
GTTGCTCTAAAGGCCAGACAGTGCAGTGCC|TTCTATCATGAAAATAGATATGTGCCCGTT
AGTGCCCCTCATGATAGGCGGAAACTAGTG|CAAAGTTCTGACCCAGTTGGAACGTTGGTT
GGAAACTAGTTCAGTTCGAATTCAGTGCCC|GTCTCTTCCATTCGAGCACAGCCCAGCTGT
TAGTGAGTAATTCCTCGAGGCAGCTAGGTG|AGCTGTTAGGTCCTTCCTCCGCCGAAGCTT
TTGGAACGTTGGTTTTGGTCCCGACACGAT|ATCTGTAACAGCACAGGAAGTCGGACGATC
TAGCCTAAAATCCACCCCTGCGAAAACGCC|GTATGGGCAGTGCCCCTCATGATAGGCGGA
CGACACGATCGACCAGGATTACGTCGAGTC|CGGACGATCTCGTTCGCATATCGTTTCGCA
GGCGAGAGACTGTATGGGCAGTGCCCCTCA|GGCGGAAACTAGTTAGGCAGAACTGGAACT
CCTTCGACGGAACATTCTGACTCCAGTGCC|TCATGATAGGCGGAAACTAGTTGCGAAGGT
GTGCCCCTCATGATAGGCGGAAACTAGTAA|AACTGGAACTTCCCACCCGACCTGTGGAGA
TATCAGTGCCCCTCATGATAGGCGGAAACT|GGCTCAAAGTTCTGACCCAGTTGGAACGTT
TGGTATCTTGAGAAACGGACTGGGGGTAGG|TTAGATCACTGAAACCATTTCACTTGTCTA
ACATTCTGACTCCAGTGCCCCTCATGATAC|GGAAACTAGTTGCGAAGGTTCCTCTAGGCT
TAGGTACCGCACAGCCCACGCTACCGCAGT|GCCCCTCATGATACAGTGCCCCTCATGATA
ACTGGAACTTCCCACCCGACCTGTGGAGAA|GCCCCTCATGATAGGCGGAAACTAGTGCGT
ACTACTAGCATCTCCGCAAGTCGACGCTCA|GTGGGAGGCGTAGTGCAGAGCCTAGGTCGC
GGCGGAAACTAGTAAACTAGTGATAGCCGG|CCTGTCTTAGAGAAGAGCGACAGTGCCCCT
GGACTGGGGGTAGGTTGACAACGCCGACAA|ATTTCACTTGTCTAAGATTAGCCTAAAATC
GATTACGTCGAGTCAGTGCCCCTCATGATA|CATATCGTTTCGCAGAGGGTGCGGGAGCTC
TGATAGGCGGAAACTAGTGCGTCAGTGCCC|TCATGATAGGCGGAAACTAGTCCCCTCATG
CTCATGATAGGCGGAAACTAGTCCCCTCAT|TCCACAATCCGTCTAAACCGATCTACTACT
TGGGGCCACCCTAACTATACGGTTTCTATT|ACAGCCCACGCTACCGCAGTGCCCCTCATG
TGCTTACCGAAAAATTCCAAGCTGTCCTGT|AGGCAGCTAGGTGGTATCTTGAGAAACGGA
GTGCCCCTCATGATACAGTGCCCCTCATGA|AAGGTTCCTCTAGGCTGAAAGACGGCGAGA
AACCAGATCCCACCAACCCGTGGGGCCACC|AACTATTCCTTAGGTACCGCACAGCCCACG
CCCAGCTGTCTTTTTGCCCAATCAGTCAGC|CAATCGCGTGTAAACGCTCTTCTGTAACCA
TCTAAACCGATCTACTACTAGCATCTCCGC|TAGGCGGAAACTAGTGGGAGGCGTAGTGCA
AAAGGCGAGGGAAGGCTCAGTGCCCCTCAT|CGACACTGGAATCTATGCCTAGACGGGAAA
GTCTAAACCGATCTACTACTAGCATCTCCG|ATAGGCGGAAACTAGTGGGAGGCGTAGTGC
CACTGGAATCTATGCCTAGACGGGAAAGTG|TAGGCGGAAACTAGTGAGTAATTCCTCGAG
ATTCTGACTCCAGTGCCCCTCATGATACAG|AAACTAGTTGCGAAGGTTCCTCTAGGCTGA
CCTGTGGAGAAGTGGCCAATCCTTCGACGG|AACTAGTGCGTCAGTGCCCCTCATGATAGG
TGAAAGACGGCGAGACCGGTGGATATGGTT|GATAGGCGGAAACTAGTGTATCTTTTGTTC
AAGGACGCGGGTCTCTTCCATTCGAGCACA|TCCACCCCTGCGAAAACGCCCCGTTGCGAT
GTTGCGAAGGTTCCTCTAGGCTGAAAGACG|CCAAATATCAGTGCCCCTCATGATAGGCGG
AGTTCGAATTCAGTGCCCCTCATGATAGGC|CGAGCACAGCCCAGCTGTCTTTTTGCCCAA
GTTCTGACCCAGTTGGAACGTTGGTTTTGG|TGCGAGACGAAGATCTGTAACAGCACAGGA
GCCCCTCATGATAGGCGGAAACTAGTGGCG|AGACGGCGAGACCGGTGGATATGGTTGCTC
GCGGAAACTAGTGAGCCCAAATATCAGTGC|CTCCGCAAGTCGACGCTCAGAGGCTCAAAG
TGTATCTTTTGTTCTATCATGAAAATAGAT|TTTTGGTCCCGACACGATCGACCAGGATTA
CTAGTTCAGTTCGAATTCAGTGCCCCTCAT|TTCCATTCGAGCACAGCCCAGCTGTCTTTT
ATGATAGGCGGAAACTAGTAAGTTGCTTCG|TTCCCACCCGACCTGTGGAGAAGTGGCCAA
GCGAAGGTTCCTCTAGGCTGAAAGACGGCG|AATATCAGTGCCCCTCATGATAGGCGGAAA
GAACGTTGGTTTTGGTCCCGACACGATCGA|TGTAACAGCACAGGAAGTCGGACGATCTCG
GAGAAACGGACTGGGGGTAGGTTGACAACG|TGAAACCATTTCACTTGTCTAAGATTAGCC
AGCCGGATGGTAGAGATCGTGGAACCGTCA|GCCCCTCATGATAGGCGGAAACTAGTTCAG
GGAAACTAGTTGTACAGTGCCCCTCATGAT|CTAAAGGCCAGACAGTGCAGTGCCCCTCAT
TGCCCCTCATGATAGGCGGAAACTAGTTAG|AGGCGGAAACTAGTGGCGGAAACTAGTTGT
GCACAGCCCAGCTGTCTTTTTGCCCAATCA|GCGATACAATCGCGTGTAAACGCTCTTCTG
CCCGTTGCGATACAATCGCGTGTAAACGCT|AAACTAGTAAGTTGCTTCGACCAGACCGGG
GGAAACTAGTGTATCTTTTGTTCTATCATG|GAACGTTGGTTTTGGTCCCGACACGATCGA
GAACTCAATTACTTTCGCGACACTGGAATC|GAATTCAGTGCCCCTCATGATAGGCGGAAA
AGAGAAGAGCGACAGTGCCCCTCATGATAG|GGGGTAGGTTGACAACGCCGACAAGGACGC
AGAAACGGACTGGGGGTAGGTTGACAACGC|GAAACCATTTCACTTGTCTAAGATTAGCCT
GCCTAGACGGGAAAGTGCTTACCGAAAAAT|GTGAGTAATTCCTCGAGGCAGCTAGGTGGT
CAGAACTGGAACTTCCCACCCGACCTGTGG|CAGTGCCCCTCATGATAGGCGGAAACTAGT
GCTCAAAGTTCTGACCCAGTTGGAACGTTG|TTAGGGATGCGAGACGAAGATCTGTAACAG
GGGGCCACCCTAACTATACGGTTTCTATTC|CAGCCCACGCTACCGCAGTGCCCCTCATGA
CGCACAGCCCACGCTACCGCAGTGCCCCTC|ATGATACAGTGCCCCTCATGATAGGCGGAA
AGGCAGCTAGGTGGTATCTTGAGAAACGGA|TCCGCCGAAGCTTAGATCACTGAAACCATT
CCCTCATGATAGGCGGAAACTAGTAAGTTG|GGAACTTCCCACCCGACCTGTGGAGAAGTG
AGTAAGTTGCTTCGACCAGACCGGGCACCC|GGAGAAGTGGCCAATCCTTCGACGGAACAT
CTAAAATCCACCCCTGCGAAAACGCCCCGT|GGGCAGTGCCCCTCATGATAGGCGGAAACT
GGAAAGTGCTTACCGAAAAATTCCAAGCTG|TCCTCGAGGCAGCTAGGTGGTATCTTGAGA
TTCTGACTCCAGTGCCCCTCATGATACAGT|AACTAGTTGCGAAGGTTCCTCTAGGCTGAA
GCGGAAACTAGTGGCGGAAACTAGTTGTAC|GTGGATATGGTTGCTCTAAAGGCCAGACAG
ACGGCGAGACCGGTGGATATGGTTGCTCTA|CGGAAACTAGTGTATCTTTTGTTCTATCAT
TTACGTCGAGTCAGTGCCCCTCATGATAGG|TATCGTTTCGCAGAGGGTGCGGGAGCTCCC
CACTGAAACCATTTCACTTGTCTAAGATTA|ATACGGTTTCTATTCGTGGCGAGAGACTGT
GTATGGGCAGTGCCCCTCATGATAGGCGGA|GTTAGGCAGAACTGGAACTTCCCACCCGAC
GCCCCTCATGATAGGCGGAAACTAGTGTAT|AGTTCTGACCCAGTTGGAACGTTGGTTTTG
TCATGATAGGCGGAAACTAGTTGCGAAGGT|TAGGCGGAAACTAGTGAGCCCAAATATCAG
CACAGCCCACGCTACCGCAGTGCCCCTCAT|GATACAGTGCCCCTCATGATAGGCGGAAAC
CCTTCCTCCGCCGAAGCTTAGATCACTGAA|CAACCCGTGGGGCCACCCTAACTATACGGT
CTAGTTAGGCAGAACTGGAACTTCCCACCC|CTAGTTGTACAGTGCCCCTCATGATAGGCG
AACCGTCAAAAGAACTCAATTACTTTCGCG|TAGTTCAGTTCGAATTCAGTGCCCCTCATG
CGTTGCGATACAATCGCGTGTAAACGCTCT|ACTAGTAAGTTGCTTCGACCAGACCGGGCA
CTAGTAAACTAGTGATAGCCGGATGGTAGA|AGAGAAGAGCGACAGTGCCCCTCATGATAG
GTCTCTTCCATTCGAGCACAGCCCAGCTGT|CGAAAACGCCCCGTTGCGATACAATCGCGT
ACAACGCCGACAAGGACGCGGGTCTCTTCC|TTAGCCTAAAATCCACCCCTGCGAAAACGC
TGATAGGCGGAAACTAGTGGCGGAAACTAG|AGACCGGTGGATATGGTTGCTCTAAAGGCC
GTAAACGCTCTTCTGTAACCAGATCCCACC|CAGACCGGGCACCCGGAACTATTCCTTAGG
ACAATCGCGTGTAAACGCTCTTCTGTAACC|TTGCTTCGACCAGACCGGGCACCCGGAACT
CTCATGATAGGCGGAAACTAGTGTATCTTT|CTGACCCAGTTGGAACGTTGGTTTTGGTCC
CTGCGAAAACGCCCCGTTGCGATACAATCG|CATGATAGGCGGAAACTAGTAAGTTGCTTC
TAGGCGGAAACTAGTGGCGGAAACTAGTTG|CCGGTGGATATGGTTGCTCTAAAGGCCAGA
CTGTGGAGAAGTGGCCAATCCTTCGACGGA|ACTAGTGCGTCAGTGCCCCTCATGATAGGC
CGCAAGTCGACGCTCAGAGGCTCAAAGTTC|GCAGAGCCTAGGTCGCATCTTAGGGATGCG
AACGTTGGTTTTGGTCCCGACACGATCGAC|GTAACAGCACAGGAAGTCGGACGATCTCGT
GTGGAGAAGTGGCCAATCCTTCGACGGAAC|TAGTGCGTCAGTGCCCCTCATGATAGGCGG
TGACCCAGTTGGAACGTTGGTTTTGGTCCC|AGACGAAGATCTGTAACAGCACAGGAAGTC
TCTAAAGGCCAGACAGTGCAGTGCCCCTCA|TCATGAAAATAGATATGTGCCCGTTTTCCA
CCCGACCTGTGGAGAAGTGGCCAATCCTTC|GCGGAAACTAGTGCGTCAGTGCCCCTCATG
GGCAGCTAGGTGGTATCTTGAGAAACGGAC|CCGCCGAAGCTTAGATCACTGAAACCATTT
TCTGACTCCAGTGCCCCTCATGATACAGTG|ACTAGTTGCGAAGGTTCCTCTAGGCTGAAA
CTAGTGGCGGAAACTAGTTGTACAGTGCCC|TGGTTGCTCTAAAGGCCAGACAGTGCAGTG
ATGGGCAGTGCCCCTCATGATAGGCGGAAA|TAGGCAGAACTGGAACTTCCCACCCGACCT
CGAGGCAGCTAGGTGGTATCTTGAGAAACG|CCTCCGCCGAAGCTTAGATCACTGAAACCA
GCCCCTCATGATAGGCGGAAACTAGTGCGT|AGTGCCCCTCATGATAGGCGGAAACTAGTC
TGATAGGCGGAAACTAGTAAAAAGGCGAGG|AAAGAACTCAATTACTTTCGCGACACTGGA
TAGTAAGTTGCTTCGACCAGACCGGGCACC|TGGAGAAGTGGCCAATCCTTCGACGGAACA
AGTCAGTGCCCCTCATGATAGGCGGAAACT|CGCAGAGGGTGCGGGAGCTCCCGGGGACGT
GAAGAGCGACAGTGCCCCTCATGATAGGCG|GTAGGTTGACAACGCCGACAAGGACGCGGG
CTAGGTGGTATCTTGAGAAACGGACTGGGG|GAAGCTTAGATCACTGAAACCATTTCACTT
GGATATGGTTGCTCTAAAGGCCAGACAGTG|TCTTTTGTTCTATCATGAAAATAGATATGT
ACTGGGGGTAGGTTGACAACGCCGACAAGG|TTCACTTGTCTAAGATTAGCCTAAAATCCA
AAAAGAACTCAATTACTTTCGCGACACTGG|GTTCGAATTCAGTGCCCCTCATGATAGGCG
CCCTCATGATAGGCGGAAACTAGTGTATCT|TTCTGACCCAGTTGGAACGTTGGTTTTGGT
GTAAGTTGCTTCGACCAGACCGGGCACCCG|GAGAAGTGGCCAATCCTTCGACGGAACATT
ACTAGTGATAGCCGGATGGTAGAGATCGTG|AGCGACAGTGCCCCTCATGATAGGCGGAAA
CCAATCAGTCAGCTGTTAGGTCCTTCCTCC|TCTTCTGTAACCAGATCCCACCAACCCGTG
AATATCAGTGCCCCTCATGATAGGCGGAAA|GAGGCTCAAAGTTCTGACCCAGTTGGAACG
TAGGCGGAAACTAGTCCCCTCATGATAGGC|TCCGTCTAAACCGATCTACTACTAGCATCT
CAGACCGGGCACCCGGAACTATTCCTTAGG|CTTCGACGGAACATTCTGACTCCAGTGCCC
CCACCCGACCTGTGGAGAAGTGGCCAATCC|TAGGCGGAAACTAGTGCGTCAGTGCCCCTC
CCGACCTGTGGAGAAGTGGCCAATCCTTCG|CGGAAACTAGTGCGTCAGTGCCCCTCATGA
GAGATCGTGGAACCGTCAAAAGAACTCAAT|AGGCGGAAACTAGTTCAGTTCGAATTCAGT
CAGCTGTCTTTTTGCCCAATCAGTCAGCTG|ATCGCGTGTAAACGCTCTTCTGTAACCAGA
GTTGGTTTTGGTCCCGACACGATCGACCAG|ACAGCACAGGAAGTCGGACGATCTCGTTCG
CGGAAACTAGTAAAAAGGCGAGGGAAGGCT|TCAATTACTTTCGCGACACTGGAATCTATG
TGGGCAGTGCCCCTCATGATAGGCGGAAAC|AGGCAGAACTGGAACTTCCCACCCGACCTG
TGATAGCCGGATGGTAGAGATCGTGGAACC|CAGTGCCCCTCATGATAGGCGGAAACTAGT
TATGCCTAGACGGGAAAGTGCTTACCGAAA|CTAGTGAGTAATTCCTCGAGGCAGCTAGGT
